Program Name,2024-25 Seat Capacity,2024-25 Female Supernumerary,2024-25 Total,2025-26 Seat Capacity,2025-26 Female Supernumerary,2025-26 Total,Difference
"Abu Dhabi Campus - Chemical Engineering (4 Years, Bachelor of Technology)",0,0,0,10,0,10,10
"Abu Dhabi Campus - Computer Science and Engineering (4 Years, Bachelor of Technology)",0,0,0,10,0,10,10
"Abu Dhabi Campus - Energy Engineering (4 Years, Bachelor of Technology)",0,0,0,10,0,10,10
"Aeronautical Engineering (4 Years, Bachelor of Technology)",0,0,0,60,0,60,60
"Aerospace Engineering (4 Years, Bachelor of Technology)",245,30,275,325,26,351,76
"Aerospace Engineering (4 Years, Bachelor of Technology) DELHI (NCT) CHANDIGARH (UT)",12,0,12,12,0,12,0
"Aerospace Engineering (4 Years, Bachelor of Technology) Other than DELHI (NCT) CHANDIGARH (UT)",12,0,12,12,0,12,0
"Aerospace Engineering (4 Years, Bachelor of Technology) Other than WEST BENGAL",0,0,0,26,0,26,26
"Aerospace Engineering (4 Years, Bachelor of Technology) WEST BENGAL",0,0,0,25,0,25,25
"Aerospace Engineering (5 Years, Bachelor and Master of Technology (Dual Degree))",10,0,10,10,0,10,0
"Agricultural Engineering (4 Years, Bachelor of Technology)",0,0,0,62,0,62,62
"Agricultural and Food Engineering (4 Years, Bachelor of Technology)",88,5,93,88,5,93,0
"Animation and VFX (4 Years, Bachelor of Technology)",0,0,0,60,0,60,60
"Applied Geology (4 Years, Bachelor of Science)",52,0,52,52,0,52,0
"Applied Geology (5 Years, Integrated Master of Technology)",19,2,21,19,2,21,0
"Applied Geophysics (4 Years, Bachelor of Science)",0,0,0,25,3,28,28
"Applied Geophysics (5 Years, Integrated Master of Technology)",19,2,21,19,2,21,0
"Architecture (5 Years, Bachelor of Architecture)",93,3,96,472,3,475,379
"Architecture (5 Years, Bachelor of Architecture) BIHAR",23,0,23,20,0,20,-3
"Architecture (5 Years, Bachelor of Architecture) CHHATTISGARH",20,0,20,20,0,20,0
"Architecture (5 Years, Bachelor of Architecture) HARYANA",0,0,0,20,0,20,20
"Architecture (5 Years, Bachelor of Architecture) HIMACHAL PRADESH",29,0,29,29,0,29,0
"Architecture (5 Years, Bachelor of Architecture) KERALA",29,0,29,30,0,30,1
"Architecture (5 Years, Bachelor of Architecture) MADHYA PRADESH",40,10,50,40,10,50,0
"Architecture (5 Years, Bachelor of Architecture) MAHARASHTRA",0,0,0,39,0,39,39
"Architecture (5 Years, Bachelor of Architecture) ODISHA",10,0,10,10,0,10,0
"Architecture (5 Years, Bachelor of Architecture) Other than BIHAR",22,0,22,20,0,20,-2
"Architecture (5 Years, Bachelor of Architecture) Other than CHHATTISGARH",20,0,20,20,0,20,0
"Architecture (5 Years, Bachelor of Architecture) Other than HARYANA",0,0,0,20,0,20,20
"Architecture (5 Years, Bachelor of Architecture) Other than HIMACHAL PRADESH",29,0,29,29,0,29,0
"Architecture (5 Years, Bachelor of Architecture) Other than KERALA",30,0,30,29,0,29,-1
"Architecture (5 Years, Bachelor of Architecture) Other than MADHYA PRADESH",40,10,50,40,10,50,0
"Architecture (5 Years, Bachelor of Architecture) Other than MAHARASHTRA",0,0,0,39,0,39,39
"Architecture (5 Years, Bachelor of Architecture) Other than ODISHA",10,0,10,10,0,10,0
"Architecture (5 Years, Bachelor of Architecture) Other than RAJASTHAN",39,0,39,39,0,39,0
"Architecture (5 Years, Bachelor of Architecture) Other than TAMIL NADU",28,0,28,28,0,28,0
"Architecture (5 Years, Bachelor of Architecture) Other than WEST BENGAL",0,0,0,12,0,12,12
"Architecture (5 Years, Bachelor of Architecture) RAJASTHAN",38,0,38,38,0,38,0
"Architecture (5 Years, Bachelor of Architecture) TAMIL NADU",29,0,29,29,0,29,0
"Architecture (5 Years, Bachelor of Architecture) WEST BENGAL",0,0,0,12,0,12,12
"Architecture and Planning (5 Years, Bachelor of Architecture) HARYANA",20,0,20,0,0,0,-20
"Architecture and Planning (5 Years, Bachelor of Architecture) Other than HARYANA",20,0,20,0,0,0,-20
"Artificial Intelligence (4 Years, Bachelor of Technology)",83,12,95,212,38,250,155
"Artificial Intelligence (4 Years, Bachelor of Technology) GUJARAT",0,0,0,60,0,60,60
"Artificial Intelligence (4 Years, Bachelor of Technology) KARNATAKA",20,0,20,20,0,20,0
"Artificial Intelligence (4 Years, Bachelor of Technology) ODISHA",23,0,23,23,0,23,0
"Artificial Intelligence (4 Years, Bachelor of Technology) Other than GUJARAT",0,0,0,60,0,60,60
"Artificial Intelligence (4 Years, Bachelor of Technology) Other than KARNATAKA",20,0,20,20,0,20,0
"Artificial Intelligence (4 Years, Bachelor of Technology) Other than ODISHA",22,0,22,22,0,22,0
"Artificial Intelligence (5 Years, Integrated B. Tech. and M. Tech.) GUJARAT",0,0,0,30,0,30,30
"Artificial Intelligence (5 Years, Integrated B. Tech. and M. Tech.) Other than GUJARAT",0,0,0,30,0,30,30
"Artificial Intelligence and Data Analytics (4 Years, Bachelor of Technology)",50,0,50,50,0,50,0
"Artificial Intelligence and Data Engineering (4 Years, Bachelor of Technology)",19,1,20,127,13,140,120
"Artificial Intelligence and Data Engineering (4 Years, Bachelor of Technology) Other than RAJASTHAN",20,0,20,20,0,20,0
"Artificial Intelligence and Data Engineering (4 Years, Bachelor of Technology) RAJASTHAN",20,0,20,20,0,20,0
"Artificial Intelligence and Data Science (4 Years, Bachelor of Technology)",102,18,120,395,32,427,307
"Artificial Intelligence and Data Science (4 Years, Bachelor of Technology) BIHAR",0,0,0,38,0,38,38
"Artificial Intelligence and Data Science (4 Years, Bachelor of Technology) DELHI (NCT) CHANDIGARH (UT)",10,0,10,10,0,10,0
"Artificial Intelligence and Data Science (4 Years, Bachelor of Technology) HARYANA",30,0,30,30,0,30,0
"Artificial Intelligence and Data Science (4 Years, Bachelor of Technology) Other than BIHAR",0,0,0,37,0,37,37
"Artificial Intelligence and Data Science (4 Years, Bachelor of Technology) Other than DELHI (NCT) CHANDIGARH (UT)",10,0,10,10,0,10,0
"Artificial Intelligence and Data Science (4 Years, Bachelor of Technology) Other than HARYANA",30,0,30,30,0,30,0
"Artificial Intelligence and Machine Learning (4 Years, Bachelor of Technology)",0,0,0,134,12,146,146
"Artificial Intelligence and Machine Learning (4 Years, Bachelor of Technology) HARYANA",30,0,30,30,0,30,0
"Artificial Intelligence and Machine Learning (4 Years, Bachelor of Technology) Other than HARYANA",30,0,30,30,0,30,0
"Artificial Intelligence and Machine Learning (4 Years, Bachelor of Technology) Other than SIKKIM",15,0,15,15,0,15,0
"Artificial Intelligence and Machine Learning (4 Years, Bachelor of Technology) SIKKIM",15,0,15,15,0,15,0
"B. Tech in CE. - M. Tech. in Geotechnical Engineering (5 Years, B.Tech. + M.Tech./MS (Dual Degree))",10,0,10,10,0,10,0
"B. Tech in CE. - M. Tech. in Structural Engineering (5 Years, B.Tech. + M.Tech./MS (Dual Degree))",10,0,10,10,0,10,0
"B. Tech in Electronics and Communication Engineering with minor in Wearable Electronics (4 Years, Bachelor of Technology)",0,0,0,60,0,60,60
"B. Tech. (CSE) and M.Tech in CSE (5 Years, B.Tech. + M.Tech./MS (Dual Degree))",10,0,10,10,0,10,0
"B. Tech. (ECE) - M. Tech. in VLSI (5 Years, B.Tech. + M.Tech./MS (Dual Degree))",10,0,10,0,0,0,-10
"B. Tech. (ECE) -M. Tech. in VLSI (5 Years, B.Tech. + M.Tech./MS (Dual Degree))",0,0,0,10,0,10,10
"B. Tech. (EEE)-M. Tech. in (Power & Control) (5 Years, B.Tech. + M.Tech./MS (Dual Degree))",10,0,10,0,0,0,-10
"B. Tech. (EEE)-M. Tech. in (Power &. Control) (5 Years, B.Tech. + M.Tech./MS (Dual Degree))",0,0,0,10,0,10,10
"B. Tech. (ME) - M. Tech. in Mechatronics (5 Years, B.Tech. + M.Tech./MS (Dual Degree))",10,0,10,10,0,10,0
"B. Tech. (Mathematics & Computing) M. Tech. in (Mathematics & Computing) (5 Years, B.Tech. + M.Tech./MS (Dual Degree))",10,0,10,10,0,10,0
"B. Tech. and M. Tech. in Engineering and Computational Mechanics (Dual Degree) (5 Years, Bachelor and Master of Technology (Dual Degree)) MADHYA PRADESH",0,0,0,12,3,15,15
"B. Tech. and M. Tech. in Engineering and Computational Mechanics (Dual Degree) (5 Years, Bachelor and Master of Technology (Dual Degree)) Other than MADHYA PRADESH",0,0,0,12,3,15,15
"B.Tech (Artificial Intelligence and Data Science) - MBA in Digital Business Management (IIM Bodh Gaya) (5 Years, Bachelor of Technology and MBA (Dual Degree))",5,0,5,5,0,5,0
"B.Tech (Chemical Engineering) - MBA in Hospital and Health Care Management (IIM Bodh Gaya) (5 Years, Bachelor of Technology and MBA (Dual Degree))",5,0,5,5,0,5,0
"B.Tech (Chemical Science and Technology) - MBA in Hospital and Health Care Management (IIM Bodh Gaya) (5 Years, Bachelor of Technology and MBA (Dual Degree))",5,0,5,5,0,5,0
"B.Tech (Civil Engineering) - MBA (IIM Bodh Gaya) (5 Years, Bachelor of Technology and MBA (Dual Degree))",6,0,6,6,0,6,0
"B.Tech (Computer Science and Engineering) - MBA in Digital Business Management (IIM Bodh Gaya) (5 Years, Bachelor of Technology and MBA (Dual Degree))",5,0,5,5,0,5,0
"B.Tech (Electrical and Electronics Engineering) - MBA (IIM Bodh Gaya) (5 Years, Bachelor of Technology and MBA (Dual Degree))",6,0,6,6,0,6,0
"B.Tech (Electronics and Communication Engineering) - MBA in Hospital and Healthcare Management (IIM Bodh Gaya) (5 Years, Bachelor of Technology and MBA (Dual Degree))",5,0,5,5,0,5,0
"B.Tech (Engineering Physics) - MBA (IIM Bodh Gaya) (5 Years, Bachelor of Technology and MBA (Dual Degree))",6,0,6,6,0,6,0
"B.Tech (Mathematics and Computing) - MBA in Digital Business Management (IIM Bodh Gaya) (5 Years, Bachelor of Technology and MBA (Dual Degree))",5,0,5,5,0,5,0
"B.Tech (Mechanical Engineering) - MBA (IIM Mumbai) (5 Years, Bachelor of Technology and MBA (Dual Degree))",15,0,15,15,0,15,0
"B.Tech (Metallurgical and Materials Engineering) - MBA (IIM Bodh Gaya) (5 Years, Bachelor of Technology and MBA (Dual Degree))",6,0,6,6,0,6,0
"B.Tech Mining Engineering and MBA in Logistic and Supply Chain Management (IIM Mumbai) (5 Years, Integrated B. Tech. and MBA)",0,0,0,60,0,60,60
"B.Tech in Artificial Intelligenece and Data Science (Transportation and Logistics) (4 Years, Bachelor of Technology)",0,0,0,60,4,64,64
"B.Tech in Aviation Engineering (4 Years, Bachelor of Technology)",0,0,0,40,0,40,40
"B.Tech in CSE (AI and ML) (4 Years, Bachelor of Technology)",0,0,0,60,0,60,60
"B.Tech in Civil Engineering (Rail Engineering) (4 Years, Bachelor of Technology)",0,0,0,60,8,68,68
"B.Tech in Electrical Engineering ( Rail Engineering) (4 Years, Bachelor of Technology)",0,0,0,60,0,60,60
"B.Tech in Electronics & Communication Engineering (Rail Engineering) (4 Years, Bachelor of Technology)",0,0,0,60,9,69,69
"B.Tech in General Engineering (4 Years, Bachelor of Technology)",30,0,30,30,0,30,0
"B.Tech in Materials Science and Engineering (4 Years, Bachelor of Technology)",30,0,30,30,0,30,0
"B.Tech in Mathematics and Computing (4 Years, Bachelor of Technology)",30,0,30,140,0,140,110
"B.Tech in Mathematics and Computing (4 Years, Bachelor of Technology) Other than WEST BENGAL",30,0,30,30,0,30,0
"B.Tech in Mathematics and Computing (4 Years, Bachelor of Technology) WEST BENGAL",30,0,30,30,0,30,0
"B.Tech in Mechanical Engineering ( Rail Engineering) (4 Years, Bachelor of Technology)",0,0,0,60,5,65,65
"B.Tech in Mechanical Engineering and M.Tech in AI and Robotics (5 Years, B.Tech. + M.Tech./MS (Dual Degree))",0,0,0,37,9,46,46
"B.Tech in Microelectronics & VLSI (4 Years, Bachelor of Technology)",30,0,30,30,0,30,0
"B.Tech. (Civil Engineering) - MBA (5 Years, Bachelor of Technology and MBA (Dual Degree))",0,0,0,5,0,5,5
"B.Tech. (Computer Science and Engineering) - MBA (5 Years, Bachelor of Technology and MBA (Dual Degree))",0,0,0,5,0,5,5
"B.Tech. (Elctrical Engineering) - MBA (5 Years, Bachelor of Technology and MBA (Dual Degree))",0,0,0,5,0,5,5
"B.Tech. (Electronics and Communication Engineering) - MBA (5 Years, Bachelor of Technology and MBA (Dual Degree))",0,0,0,5,0,5,5
"B.Tech. (Food Engineering and Technology) - MBA (5 Years, Bachelor of Technology and MBA (Dual Degree))",0,0,0,5,0,5,5
"B.Tech. (Mechanical Engineering) - MBA (5 Years, Bachelor of Technology and MBA (Dual Degree))",0,0,0,5,0,5,5
"B.Tech. in Electronics and Communication Engineering and M.Tech. in Communication Systems (5 Years, Bachelor and Master of Technology (Dual Degree))",10,0,10,26,4,30,20
"B.Tech. in Electronics and Communication Engineering and M.Tech. in Microelectronics and VLSI Systems (5 Years, Bachelor and Master of Technology (Dual Degree))",0,0,0,17,4,21,21
"BS in Chemical Sciences (4 Years, Bachelor of Science)",30,0,30,30,0,30,0
"BS in Economics with MBA (IIM Bodh Gaya) (5 Years, Bachelor of Science and MBA (Dual Degree))",6,0,6,6,0,6,0
"BS in Mathematics (4 Years, Bachelor of Science)",18,0,18,18,0,18,0
"Bachelor of Design (4 Years, Bachelor of Design)",0,0,0,2,0,2,2
"Bio Engineering (4 Years, Bachelor of Technology)",70,10,80,70,10,80,0
"Bio Medical Engineering (4 Years, Bachelor of Technology)",0,0,0,30,0,30,30
"Bio Medical Engineering (4 Years, Bachelor of Technology) CHHATTISGARH",39,1,40,39,1,40,0
"Bio Medical Engineering (4 Years, Bachelor of Technology) ODISHA",17,0,17,17,0,17,0
"Bio Medical Engineering (4 Years, Bachelor of Technology) Other than CHHATTISGARH",40,0,40,40,0,40,0
"Bio Medical Engineering (4 Years, Bachelor of Technology) Other than ODISHA",18,0,18,18,0,18,0
"Bio Technology (4 Years, Bachelor of Technology)",0,0,0,44,3,47,47
"Bio Technology (4 Years, Bachelor of Technology) ANDHRA PRADESH",0,0,0,15,0,15,15
"Bio Technology (4 Years, Bachelor of Technology) CHHATTISGARH",40,0,40,40,0,40,0
"Bio Technology (4 Years, Bachelor of Technology) KERALA",18,0,18,19,0,19,1
"Bio Technology (4 Years, Bachelor of Technology) ODISHA",17,0,17,17,0,17,0
"Bio Technology (4 Years, Bachelor of Technology) Other than ANDHRA PRADESH",0,0,0,15,0,15,15
"Bio Technology (4 Years, Bachelor of Technology) Other than CHHATTISGARH",39,0,39,39,0,39,0
"Bio Technology (4 Years, Bachelor of Technology) Other than KERALA",19,0,19,18,0,18,-1
"Bio Technology (4 Years, Bachelor of Technology) Other than ODISHA",18,0,18,18,0,18,0
"Bio Technology (4 Years, Bachelor of Technology) Other than PUNJAB",25,0,25,25,0,25,0
"Bio Technology (4 Years, Bachelor of Technology) Other than TELANGANA",36,0,36,36,0,36,0
"Bio Technology (4 Years, Bachelor of Technology) Other than UTTAR PRADESH",29,1,30,29,1,30,0
"Bio Technology (4 Years, Bachelor of Technology) Other than WEST BENGAL",37,0,37,37,0,37,0
"Bio Technology (4 Years, Bachelor of Technology) PUNJAB",25,0,25,25,0,25,0
"Bio Technology (4 Years, Bachelor of Technology) TELANGANA",36,0,36,36,0,36,0
"Bio Technology (4 Years, Bachelor of Technology) UTTAR PRADESH",28,2,30,28,2,30,0
"Bio Technology (4 Years, Bachelor of Technology) WEST BENGAL",38,0,38,38,0,38,0
"Biochemical Engineering (4 Years, Bachelor of Technology)",0,0,0,25,0,25,25
"Biochemical Engineering with M.Tech. in Biochemical Engineering and Biotechnology (5 Years, Bachelor and Master of Technology (Dual Degree))",25,0,25,0,0,0,-25
"Bioengineering (4 Years, Bachelor of Technology)",0,0,0,21,0,21,21
"Bioengineering with M.Tech in Biomedical Technology (5 Years, Bachelor and Master of Technology (Dual Degree))",20,1,21,0,0,0,-21
"Biological Engineering (4 Years, Bachelor of Technology)",40,1,41,30,0,30,-11
"Biological Science (4 Years, Bachelor of Science)",40,1,41,30,0,30,-11
"Biological Sciences and Bioengineering (4 Years, Bachelor of Technology)",42,11,53,42,11,53,0
"Biomedical Engineering (4 Years, Bachelor of Technology)",21,4,25,49,4,53,28
"Biosciences and Bioengineering (4 Years, Bachelor of Technology)",123,7,130,118,7,125,-5
"Biosciences and Bioengineering (4 Years, Bachelor of Technology) ARUNACHAL PRADESH",0,0,0,10,0,10,10
"Biosciences and Bioengineering (4 Years, Bachelor of Technology) Other than ARUNACHAL PRADESH",0,0,0,10,0,10,10
"Biotechnology (5 Years, Bachelor and Master of Technology (Dual Degree)) Other than WEST BENGAL",3,0,3,3,0,3,0
"Biotechnology (5 Years, Bachelor and Master of Technology (Dual Degree)) WEST BENGAL",4,0,4,4,0,4,0
"Biotechnology and Biochemical Engineering (4 Years, Bachelor of Technology)",138,4,142,126,4,130,-12
"Biotechnology and Biochemical Engineering (4 Years, Bachelor of Technology) Other than TRIPURA",19,6,25,23,7,30,5
"Biotechnology and Biochemical Engineering (4 Years, Bachelor of Technology) TRIPURA",19,6,25,23,7,30,5
Biotechnology and Bioinformatics,22,3,25,0,0,0,-25
"Biotechnology and Bioinformatics (4 Years, Bachelor of Technology)",0,0,0,27,3,30,30
"CSE ( Data Science & Analytics) (4 Years, Bachelor of Technology)",0,0,0,60,0,60,60
"Carpet and Textile Technology (4 Years, Bachelor of Technology)",0,0,0,30,6,36,36
"Ceramic Engineering (4 Years, Bachelor of Technology)",75,0,75,75,0,75,0
"Ceramic Engineering (4 Years, Bachelor of Technology) ODISHA",20,0,20,20,0,20,0
"Ceramic Engineering (4 Years, Bachelor of Technology) Other than ODISHA",20,0,20,20,0,20,0
"Ceramic Engineering (5 Years, Bachelor and Master of Technology (Dual Degree))",18,2,20,0,0,0,-20
"Ceramic Engineering and M.Tech Industrial Ceramic (5 Years, Bachelor and Master of Technology (Dual Degree)) ODISHA",7,0,7,7,0,7,0
"Ceramic Engineering and M.Tech Industrial Ceramic (5 Years, Bachelor and Master of Technology (Dual Degree)) Other than ODISHA",6,0,6,6,0,6,0
"Chemical Engineering (4 Years, Bachelor of Technology)",1229,109,1338,1474,122,1596,258
"Chemical Engineering (4 Years, Bachelor of Technology) ANDHRA PRADESH",0,0,0,15,0,15,15
"Chemical Engineering (4 Years, Bachelor of Technology) CHHATTISGARH",39,0,39,39,0,39,0
"Chemical Engineering (4 Years, Bachelor of Technology) GUJARAT",0,0,0,65,0,65,65
"Chemical Engineering (4 Years, Bachelor of Technology) HIMACHAL PRADESH",38,0,38,38,0,38,0
"Chemical Engineering (4 Years, Bachelor of Technology) JK JAMMU & KASHMIR (UT)",49,1,50,37,1,38,-12
"Chemical Engineering (4 Years, Bachelor of Technology) KARNATAKA",29,0,29,29,2,31,2
"Chemical Engineering (4 Years, Bachelor of Technology) KERALA",58,0,58,58,0,58,0
"Chemical Engineering (4 Years, Bachelor of Technology) LA LADAKH (UT)",2,0,2,2,0,2,0
"Chemical Engineering (4 Years, Bachelor of Technology) MADHYA PRADESH",31,8,39,29,7,36,-3
"Chemical Engineering (4 Years, Bachelor of Technology) MAHARASHTRA",0,0,0,58,0,58,58
"Chemical Engineering (4 Years, Bachelor of Technology) ODISHA",31,1,32,31,0,31,-1
"Chemical Engineering (4 Years, Bachelor of Technology) Other than ANDHRA PRADESH",0,0,0,15,0,15,15
"Chemical Engineering (4 Years, Bachelor of Technology) Other than CHHATTISGARH",40,0,40,40,0,40,0
"Chemical Engineering (4 Years, Bachelor of Technology) Other than GUJARAT",0,0,0,65,0,65,65
"Chemical Engineering (4 Years, Bachelor of Technology) Other than HIMACHAL PRADESH",38,0,38,38,0,38,0
"Chemical Engineering (4 Years, Bachelor of Technology) Other than JAMMU & KASHMIR (UT) LADAKH (UT)",50,1,51,39,1,40,-11
"Chemical Engineering (4 Years, Bachelor of Technology) Other than KARNATAKA",29,0,29,29,1,30,1
"Chemical Engineering (4 Years, Bachelor of Technology) Other than KERALA",58,0,58,58,0,58,0
"Chemical Engineering (4 Years, Bachelor of Technology) Other than MADHYA PRADESH",31,8,39,28,7,35,-4
"Chemical Engineering (4 Years, Bachelor of Technology) Other than MAHARASHTRA",0,0,0,57,0,57,57
"Chemical Engineering (4 Years, Bachelor of Technology) Other than ODISHA",31,0,31,31,0,31,0
"Chemical Engineering (4 Years, Bachelor of Technology) Other than PUNJAB",37,0,37,35,0,35,-2
"Chemical Engineering (4 Years, Bachelor of Technology) Other than RAJASTHAN",57,0,57,57,0,57,0
"Chemical Engineering (4 Years, Bachelor of Technology) Other than TAMIL NADU",39,0,39,39,0,39,0
"Chemical Engineering (4 Years, Bachelor of Technology) Other than TELANGANA",55,0,55,49,0,49,-6
"Chemical Engineering (4 Years, Bachelor of Technology) Other than TRIPURA",30,8,38,36,9,45,7
"Chemical Engineering (4 Years, Bachelor of Technology) Other than UTTAR PRADESH",28,2,30,28,2,30,0
"Chemical Engineering (4 Years, Bachelor of Technology) Other than WEST BENGAL",38,0,38,38,0,38,0
"Chemical Engineering (4 Years, Bachelor of Technology) PUNJAB",37,0,37,35,0,35,-2
"Chemical Engineering (4 Years, Bachelor of Technology) RAJASTHAN",58,0,58,58,0,58,0
"Chemical Engineering (4 Years, Bachelor of Technology) TAMIL NADU",40,0,40,40,0,40,0
"Chemical Engineering (4 Years, Bachelor of Technology) TELANGANA",55,0,55,49,0,49,-6
"Chemical Engineering (4 Years, Bachelor of Technology) TRIPURA",29,8,37,37,8,45,8
"Chemical Engineering (4 Years, Bachelor of Technology) UTTAR PRADESH",29,1,30,29,1,30,0
"Chemical Engineering (4 Years, Bachelor of Technology) WEST BENGAL",37,0,37,37,0,37,0
"Chemical Engineering (5 Years, Bachelor and Master of Technology (Dual Degree))",44,2,46,46,0,46,0
"Chemical Engineering (5 Years, Bachelor and Master of Technology (Dual Degree)) ODISHA",6,0,6,6,0,6,0
"Chemical Engineering (5 Years, Bachelor and Master of Technology (Dual Degree)) Other than ODISHA",6,0,6,6,0,6,0
"Chemical Engineering (5 Years, Bachelor and Master of Technology (Dual Degree)) Other than TELANGANA",0,0,0,6,0,6,6
"Chemical Engineering (5 Years, Bachelor and Master of Technology (Dual Degree)) Other than WEST BENGAL",3,0,3,3,0,3,0
"Chemical Engineering (5 Years, Bachelor and Master of Technology (Dual Degree)) TELANGANA",0,0,0,6,0,6,6
"Chemical Engineering (5 Years, Bachelor and Master of Technology (Dual Degree)) WEST BENGAL",4,0,4,4,0,4,0
"Chemical Engineering (5 Years, Integrated Masters in Technology)",0,0,0,66,0,66,66
"Chemical Science (5 Years, Integrated Bachelor of Science-Master of Science)",0,0,0,26,0,26,26
"Chemical Science and Technology (4 Years, Bachelor of Technology)",101,11,112,101,4,105,-7
"Chemical Science and Technology (4 Years, Bachelor of Technology) MIZORAM",0,0,0,5,0,5,5
"Chemical Science and Technology (4 Years, Bachelor of Technology) Other than MIZORAM",0,0,0,5,0,5,5
"Chemical Sciences (5 Years, Bachelor of Science and Master of Science (Dual Degree))",35,0,35,35,0,35,0
"Chemical Technology (5 Years, Bachelor and Master of Technology (Dual Degree)) BIHAR",5,0,5,6,0,6,1
"Chemical Technology (5 Years, Bachelor and Master of Technology (Dual Degree)) Other than BIHAR",5,0,5,6,0,6,1
"Chemical and Biochemical Engineering (4 Years, Bachelor of Technology)",28,2,30,28,2,30,0
"Chemistry (4 Years, Bachelor of Science)",119,10,129,159,10,169,40
"Chemistry (5 Years, Bachelor of Science and Master of Science (Dual Degree)) Other than TRIPURA",13,0,13,20,0,20,7
"Chemistry (5 Years, Bachelor of Science and Master of Science (Dual Degree)) TRIPURA",12,0,12,20,0,20,8
"Chemistry (5 Years, Integrated Master of Science)",0,0,0,10,0,10,10
"Chemistry (5 Years, Integrated Master of Science) GUJARAT",0,0,0,25,0,25,25
"Chemistry (5 Years, Integrated Master of Science) ODISHA",11,0,11,11,0,11,0
"Chemistry (5 Years, Integrated Master of Science) Other than GUJARAT",0,0,0,25,0,25,25
"Chemistry (5 Years, Integrated Master of Science) Other than ODISHA",11,0,11,11,0,11,0
"Chemistry (5 Years, Integrated Master of Science) Other than TELANGANA",0,0,0,10,0,10,10
"Chemistry (5 Years, Integrated Master of Science) Other than WEST BENGAL",10,0,10,10,0,10,0
"Chemistry (5 Years, Integrated Master of Science) TELANGANA",0,0,0,10,0,10,10
"Chemistry (5 Years, Integrated Master of Science) WEST BENGAL",9,0,9,9,0,9,0
"Chemistry with Specialization (4 Years, Bachelor of Science)",24,6,30,24,6,30,0
"Civil Engineering (4 Years, Bachelor of Technology)",1476,175,1651,2179,161,2340,689
"Civil Engineering (4 Years, Bachelor of Technology) ANDHRA PRADESH",0,0,0,30,0,30,30
"Civil Engineering (4 Years, Bachelor of Technology) ARUNACHAL PRADESH",16,0,16,21,0,21,5
"Civil Engineering (4 Years, Bachelor of Technology) ASSAM",79,0,79,79,0,79,0
"Civil Engineering (4 Years, Bachelor of Technology) BIHAR",60,0,60,58,0,58,-2
"Civil Engineering (4 Years, Bachelor of Technology) CHHATTISGARH",49,0,49,49,0,49,0
"Civil Engineering (4 Years, Bachelor of Technology) DAMAN & DIU (UT) DADRA & NAGAR HAVELI (UT) LAKSHADWEEP (UT)",4,0,4,4,0,4,0
"Civil Engineering (4 Years, Bachelor of Technology) DELHI (NCT) CHANDIGARH (UT)",13,0,13,13,0,13,0
"Civil Engineering (4 Years, Bachelor of Technology) GOA",14,0,14,14,0,14,0
"Civil Engineering (4 Years, Bachelor of Technology) GUJARAT",0,0,0,65,0,65,65
"Civil Engineering (4 Years, Bachelor of Technology) HARYANA",54,0,54,54,0,54,0
"Civil Engineering (4 Years, Bachelor of Technology) HIMACHAL PRADESH",62,0,62,61,0,61,-1
"Civil Engineering (4 Years, Bachelor of Technology) JHARKHAND",50,0,50,50,0,50,0
"Civil Engineering (4 Years, Bachelor of Technology) JK JAMMU & KASHMIR (UT)",83,4,87,77,4,81,-6
"Civil Engineering (4 Years, Bachelor of Technology) KARNATAKA",58,0,58,58,0,58,0
"Civil Engineering (4 Years, Bachelor of Technology) KERALA",86,0,86,86,0,86,0
"Civil Engineering (4 Years, Bachelor of Technology) LA LADAKH (UT)",3,2,5,2,2,4,-1
"Civil Engineering (4 Years, Bachelor of Technology) MADHYA PRADESH",45,12,57,41,10,51,-6
"Civil Engineering (4 Years, Bachelor of Technology) MAHARASHTRA",0,0,0,58,0,58,58
"Civil Engineering (4 Years, Bachelor of Technology) MANIPUR",19,0,19,19,0,19,0
"Civil Engineering (4 Years, Bachelor of Technology) MEGHALAYA",17,0,17,17,0,17,0
"Civil Engineering (4 Years, Bachelor of Technology) MIZORAM",17,1,18,15,2,17,-1
"Civil Engineering (4 Years, Bachelor of Technology) NAGALAND",15,0,15,15,0,15,0
"Civil Engineering (4 Years, Bachelor of Technology) ODISHA",36,0,36,36,0,36,0
"Civil Engineering (4 Years, Bachelor of Technology) Other than ANDHRA PRADESH",0,0,0,30,0,30,30
"Civil Engineering (4 Years, Bachelor of Technology) Other than ARUNACHAL PRADESH",16,0,16,21,0,21,5
"Civil Engineering (4 Years, Bachelor of Technology) Other than ASSAM",78,0,78,78,0,78,0
"Civil Engineering (4 Years, Bachelor of Technology) Other than BIHAR",60,0,60,58,0,58,-2
"Civil Engineering (4 Years, Bachelor of Technology) Other than CHHATTISGARH",48,0,48,48,0,48,0
"Civil Engineering (4 Years, Bachelor of Technology) Other than DELHI (NCT) CHANDIGARH (UT)",12,0,12,12,0,12,0
"Civil Engineering (4 Years, Bachelor of Technology) Other than GOA DAMAN & DIU (UT) DADRA & NAGAR HAVELI (UT) LAKSHADWEEP (UT)",19,0,19,19,0,19,0
"Civil Engineering (4 Years, Bachelor of Technology) Other than GUJARAT",0,0,0,65,0,65,65
"Civil Engineering (4 Years, Bachelor of Technology) Other than HARYANA",54,0,54,54,0,54,0
"Civil Engineering (4 Years, Bachelor of Technology) Other than HIMACHAL PRADESH",61,0,61,62,0,62,1
"Civil Engineering (4 Years, Bachelor of Technology) Other than JAMMU & KASHMIR (UT) LADAKH (UT)",88,3,91,82,3,85,-6
"Civil Engineering (4 Years, Bachelor of Technology) Other than JHARKHAND",49,0,49,49,0,49,0
"Civil Engineering (4 Years, Bachelor of Technology) Other than KARNATAKA",57,0,57,57,0,57,0
"Civil Engineering (4 Years, Bachelor of Technology) Other than KERALA",86,0,86,86,0,86,0
"Civil Engineering (4 Years, Bachelor of Technology) Other than MADHYA PRADESH",45,11,56,40,10,50,-6
"Civil Engineering (4 Years, Bachelor of Technology) Other than MAHARASHTRA",0,0,0,57,0,57,57
"Civil Engineering (4 Years, Bachelor of Technology) Other than MANIPUR",19,0,19,19,0,19,0
"Civil Engineering (4 Years, Bachelor of Technology) Other than MEGHALAYA",16,0,16,16,0,16,0
"Civil Engineering (4 Years, Bachelor of Technology) Other than MIZORAM",17,1,18,16,1,17,-1
"Civil Engineering (4 Years, Bachelor of Technology) Other than NAGALAND",18,0,18,18,0,18,0
"Civil Engineering (4 Years, Bachelor of Technology) Other than ODISHA",36,0,36,36,0,36,0
"Civil Engineering (4 Years, Bachelor of Technology) Other than PUDUCHERRY (UT) ANDAMAN & NICOBAR ISLANDS (UT)",23,0,23,22,0,22,-1
"Civil Engineering (4 Years, Bachelor of Technology) Other than PUNJAB",43,0,43,40,0,40,-3
"Civil Engineering (4 Years, Bachelor of Technology) Other than RAJASTHAN",58,0,58,58,0,58,0
"Civil Engineering (4 Years, Bachelor of Technology) Other than SIKKIM",15,0,15,15,0,15,0
"Civil Engineering (4 Years, Bachelor of Technology) Other than TAMIL NADU",59,0,59,59,0,59,0
"Civil Engineering (4 Years, Bachelor of Technology) Other than TELANGANA",55,0,55,55,0,55,0
"Civil Engineering (4 Years, Bachelor of Technology) Other than TRIPURA",46,13,59,47,13,60,1
"Civil Engineering (4 Years, Bachelor of Technology) Other than UTTAR PRADESH",58,3,61,58,3,61,0
"Civil Engineering (4 Years, Bachelor of Technology) Other than UTTARAKHAND",14,4,18,18,0,18,0
"Civil Engineering (4 Years, Bachelor of Technology) Other than WEST BENGAL",40,0,40,117,0,117,77
"Civil Engineering (4 Years, Bachelor of Technology) PUDUCHERRY (UT) ANDAMAN & NICOBAR ISLANDS (UT)",22,0,22,23,0,23,1
"Civil Engineering (4 Years, Bachelor of Technology) PUNJAB",42,0,42,40,0,40,-2
"Civil Engineering (4 Years, Bachelor of Technology) RAJASTHAN",57,0,57,57,0,57,0
"Civil Engineering (4 Years, Bachelor of Technology) SIKKIM",15,0,15,15,0,15,0
"Civil Engineering (4 Years, Bachelor of Technology) TAMIL NADU",59,0,59,59,0,59,0
"Civil Engineering (4 Years, Bachelor of Technology) TELANGANA",55,0,55,55,0,55,0
"Civil Engineering (4 Years, Bachelor of Technology) TRIPURA",46,13,59,47,13,60,1
"Civil Engineering (4 Years, Bachelor of Technology) UTTAR PRADESH",57,3,60,57,3,60,0
"Civil Engineering (4 Years, Bachelor of Technology) UTTARAKHAND",14,4,18,18,0,18,0
"Civil Engineering (4 Years, Bachelor of Technology) WEST BENGAL",40,0,40,118,0,118,78
"Civil Engineering (5 Years, Bachelor and Master of Technology (Dual Degree))",28,2,30,0,0,0,-30
"Civil Engineering (5 Years, Bachelor and Master of Technology (Dual Degree)) HARYANA",6,0,6,6,0,6,0
"Civil Engineering (5 Years, Bachelor and Master of Technology (Dual Degree)) Other than HARYANA",6,0,6,6,0,6,0
"Civil Engineering with Specialization in Construction Technology and Management (5 Years, Bachelor and Master of Technology (Dual Degree)) BIHAR",5,0,5,6,0,6,1
"Civil Engineering with Specialization in Construction Technology and Management (5 Years, Bachelor and Master of Technology (Dual Degree)) Other than BIHAR",5,0,5,6,0,6,1
"Civil and Environmental Engineering (4 Years, Bachelor of Technology)",0,0,0,38,6,44,44
"Civil and Infrastructure Engineering (4 Years, Bachelor of Technology)",76,14,90,76,14,90,0
"Computational Engineering (4 Years, Bachelor of Technology)",22,3,25,27,3,30,5
"Computational Engineering and Mechanics (4 Years, Bachelor of Technology)",0,0,0,40,0,40,40
"Computational Mathematics (5 Years, Bachelor and Master of Technology (Dual Degree)) Other than TRIPURA",13,0,13,13,0,13,0
"Computational Mathematics (5 Years, Bachelor and Master of Technology (Dual Degree)) TRIPURA",0,0,0,12,0,12,12
"Computational Mathematics (5 Years, Bachelor of Technology) TRIPURA",12,0,12,0,0,0,-12
"Computational and Data Science (4 Years, Bachelor of Technology) KARNATAKA",15,0,15,15,0,15,0
"Computational and Data Science (4 Years, Bachelor of Technology) Other than KARNATAKA",15,0,15,15,0,15,0
"Computer Engineering (4 Years, Bachelor of Technology)",0,0,0,152,4,156,156
"Computer Science (4 Years, Bachelor of Technology)",0,0,0,60,0,60,60
"Computer Science Engineering (Artificial Intelligence) (4 Years, B. Tech / B. Tech (Hons.))",0,0,0,70,0,70,70
"Computer Science Engineering (Artificial lntelligence and Machine Learning) (4 Years, Bachelor of Technology)",0,0,0,110,3,113,113
"Computer Science Engineering (Data Science and Analytics) (4 Years, Bachelor of Technology)",0,0,0,72,0,72,72
"Computer Science Engineering (Data Science) (4 Years, B. Tech / B. Tech (Hons.))",0,0,0,99,0,99,99
"Computer Science Engineering (Human Computer lnteraction and Gaming Technology) (4 Years, Bachelor of Technology)",0,0,0,72,0,72,72
"Computer Science and Artificial Intelligence (4 Years, Bachelor of Technology)",0,0,0,60,0,60,60
"Computer Science and Business (4 Years, Bachelor of Technology)",0,0,0,60,0,60,60
"Computer Science and Engineering ( Artificial Intelligence & Data Science) (4 Years, Bachelor of Technology)",0,0,0,58,2,60,60
"Computer Science and Engineering ( Artificial Intelligence & Data Science) (4 Years, Bachelor of Technology) Other than TELANGANA",0,0,0,30,0,30,30
"Computer Science and Engineering ( Artificial Intelligence & Data Science) (4 Years, Bachelor of Technology) TELANGANA",0,0,0,30,0,30,30
"Computer Science and Engineering (4 Years, Bachelor of Technology)",1781,236,2017,7102,649,7751,5734
"Computer Science and Engineering (4 Years, Bachelor of Technology) ANDHRA PRADESH",0,0,0,45,0,45,45
"Computer Science and Engineering (4 Years, Bachelor of Technology) ARUNACHAL PRADESH",16,0,16,21,0,21,5
"Computer Science and Engineering (4 Years, Bachelor of Technology) ASSAM",81,0,81,80,0,80,-1
"Computer Science and Engineering (4 Years, Bachelor of Technology) BIHAR",100,0,100,75,0,75,-25
"Computer Science and Engineering (4 Years, Bachelor of Technology) CHHATTISGARH",57,0,57,57,0,57,0
"Computer Science and Engineering (4 Years, Bachelor of Technology) DAMAN & DIU (UT) DADRA & NAGAR HAVELI (UT) LAKSHADWEEP (UT)",5,0,5,5,0,5,0
"Computer Science and Engineering (4 Years, Bachelor of Technology) DELHI (NCT) CHANDIGARH (UT)",60,0,60,60,0,60,0
"Computer Science and Engineering (4 Years, Bachelor of Technology) GOA",20,0,20,20,0,20,0
"Computer Science and Engineering (4 Years, Bachelor of Technology) GUJARAT",0,0,0,65,0,65,65
"Computer Science and Engineering (4 Years, Bachelor of Technology) HARYANA",54,0,54,54,0,54,0
"Computer Science and Engineering (4 Years, Bachelor of Technology) HIMACHAL PRADESH",62,0,62,62,0,62,0
"Computer Science and Engineering (4 Years, Bachelor of Technology) JHARKHAND",58,0,58,58,0,58,0
"Computer Science and Engineering (4 Years, Bachelor of Technology) JK JAMMU & KASHMIR (UT)",39,2,41,60,2,62,21
"Computer Science and Engineering (4 Years, Bachelor of Technology) KARNATAKA",57,0,57,57,0,57,0
"Computer Science and Engineering (4 Years, Bachelor of Technology) KERALA",86,4,90,86,3,89,-1
"Computer Science and Engineering (4 Years, Bachelor of Technology) LA LADAKH (UT)",2,0,2,3,0,3,1
"Computer Science and Engineering (4 Years, Bachelor of Technology) MADHYA PRADESH",91,23,114,91,23,114,0
"Computer Science and Engineering (4 Years, Bachelor of Technology) MAHARASHTRA",0,0,0,57,0,57,57
"Computer Science and Engineering (4 Years, Bachelor of Technology) MANIPUR",37,0,37,37,0,37,0
"Computer Science and Engineering (4 Years, Bachelor of Technology) MEGHALAYA",16,0,16,16,0,16,0
"Computer Science and Engineering (4 Years, Bachelor of Technology) MIZORAM",18,0,18,16,1,17,-1
"Computer Science and Engineering (4 Years, Bachelor of Technology) NAGALAND",15,0,15,15,0,15,0
"Computer Science and Engineering (4 Years, Bachelor of Technology) ODISHA",56,0,56,56,0,56,0
"Computer Science and Engineering (4 Years, Bachelor of Technology) Other than ANDHRA PRADESH",0,0,0,45,0,45,45
"Computer Science and Engineering (4 Years, Bachelor of Technology) Other than ARUNACHAL PRADESH",16,0,16,21,0,21,5
"Computer Science and Engineering (4 Years, Bachelor of Technology) Other than ASSAM",80,0,80,81,0,81,1
"Computer Science and Engineering (4 Years, Bachelor of Technology) Other than BIHAR",99,0,99,75,0,75,-24
"Computer Science and Engineering (4 Years, Bachelor of Technology) Other than CHHATTISGARH",57,0,57,57,0,57,0
"Computer Science and Engineering (4 Years, Bachelor of Technology) Other than DELHI (NCT) CHANDIGARH (UT)",60,0,60,60,0,60,0
"Computer Science and Engineering (4 Years, Bachelor of Technology) Other than GOA DAMAN & DIU (UT) DADRA & NAGAR HAVELI (UT) LAKSHADWEEP (UT)",25,0,25,25,0,25,0
"Computer Science and Engineering (4 Years, Bachelor of Technology) Other than GUJARAT",0,0,0,65,0,65,65
"Computer Science and Engineering (4 Years, Bachelor of Technology) Other than HARYANA",54,0,54,54,0,54,0
"Computer Science and Engineering (4 Years, Bachelor of Technology) Other than HIMACHAL PRADESH",62,0,62,62,0,62,0
"Computer Science and Engineering (4 Years, Bachelor of Technology) Other than JAMMU & KASHMIR (UT) LADAKH (UT)",39,2,41,63,2,65,24
"Computer Science and Engineering (4 Years, Bachelor of Technology) Other than JHARKHAND",58,0,58,58,0,58,0
"Computer Science and Engineering (4 Years, Bachelor of Technology) Other than KARNATAKA",58,0,58,58,0,58,0
"Computer Science and Engineering (4 Years, Bachelor of Technology) Other than KERALA",86,3,89,86,3,89,0
"Computer Science and Engineering (4 Years, Bachelor of Technology) Other than MADHYA PRADESH",92,23,115,92,23,115,0
"Computer Science and Engineering (4 Years, Bachelor of Technology) Other than MAHARASHTRA",0,0,0,58,0,58,58
"Computer Science and Engineering (4 Years, Bachelor of Technology) Other than MANIPUR",37,0,37,37,0,37,0
"Computer Science and Engineering (4 Years, Bachelor of Technology) Other than MEGHALAYA",17,0,17,17,0,17,0
"Computer Science and Engineering (4 Years, Bachelor of Technology) Other than MIZORAM",17,1,18,16,1,17,-1
"Computer Science and Engineering (4 Years, Bachelor of Technology) Other than NAGALAND",18,0,18,18,1,19,1
"Computer Science and Engineering (4 Years, Bachelor of Technology) Other than ODISHA",57,0,57,57,0,57,0
"Computer Science and Engineering (4 Years, Bachelor of Technology) Other than PUDUCHERRY (UT) ANDAMAN & NICOBAR ISLANDS (UT)",30,0,30,30,0,30,0
"Computer Science and Engineering (4 Years, Bachelor of Technology) Other than PUNJAB",79,0,79,79,0,79,0
"Computer Science and Engineering (4 Years, Bachelor of Technology) Other than RAJASTHAN",59,0,59,59,0,59,0
"Computer Science and Engineering (4 Years, Bachelor of Technology) Other than SIKKIM",20,0,20,20,0,20,0
"Computer Science and Engineering (4 Years, Bachelor of Technology) Other than TAMIL NADU",59,0,59,59,0,59,0
"Computer Science and Engineering (4 Years, Bachelor of Technology) Other than TELANGANA",67,0,67,67,0,67,0
"Computer Science and Engineering (4 Years, Bachelor of Technology) Other than TRIPURA",58,17,75,71,19,90,15
"Computer Science and Engineering (4 Years, Bachelor of Technology) Other than UTTAR PRADESH",154,8,162,154,8,162,0
"Computer Science and Engineering (4 Years, Bachelor of Technology) Other than UTTARAKHAND",21,5,26,26,0,26,0
"Computer Science and Engineering (4 Years, Bachelor of Technology) Other than WEST BENGAL",93,0,93,144,0,144,51
"Computer Science and Engineering (4 Years, Bachelor of Technology) PUDUCHERRY (UT) ANDAMAN & NICOBAR ISLANDS (UT)",30,0,30,30,0,30,0
"Computer Science and Engineering (4 Years, Bachelor of Technology) PUNJAB",79,0,79,79,0,79,0
"Computer Science and Engineering (4 Years, Bachelor of Technology) RAJASTHAN",58,0,58,58,0,58,0
"Computer Science and Engineering (4 Years, Bachelor of Technology) SIKKIM",20,0,20,20,0,20,0
"Computer Science and Engineering (4 Years, Bachelor of Technology) TAMIL NADU",60,0,60,60,0,60,0
"Computer Science and Engineering (4 Years, Bachelor of Technology) TELANGANA",68,0,68,68,0,68,0
"Computer Science and Engineering (4 Years, Bachelor of Technology) TRIPURA",59,16,75,73,17,90,15
"Computer Science and Engineering (4 Years, Bachelor of Technology) UTTAR PRADESH",154,9,163,154,9,163,0
"Computer Science and Engineering (4 Years, Bachelor of Technology) UTTARAKHAND",22,4,26,26,0,26,0
"Computer Science and Engineering (4 Years, Bachelor of Technology) WEST BENGAL",94,0,94,145,0,145,51
"Computer Science and Engineering (5 Years, Bachelor and Master of Technology (Dual Degree))",80,11,91,191,14,205,114
"Computer Science and Engineering (5 Years, Bachelor and Master of Technology (Dual Degree)) HARYANA",6,0,6,6,0,6,0
"Computer Science and Engineering (5 Years, Bachelor and Master of Technology (Dual Degree)) HIMACHAL PRADESH",14,0,14,14,0,14,0
"Computer Science and Engineering (5 Years, Bachelor and Master of Technology (Dual Degree)) Other than HARYANA",6,0,6,6,0,6,0
"Computer Science and Engineering (5 Years, Bachelor and Master of Technology (Dual Degree)) Other than HIMACHAL PRADESH",14,0,14,14,0,14,0
"Computer Science and Engineering (Artificial Intelligence and Machine Learning) (4 Years, Bachelor of Technology)",0,0,0,30,6,36,36
"Computer Science and Engineering (Artificial Intelligence) (4 Years, Bachelor of Technology)",0,0,0,60,0,60,60
"Computer Science and Engineering (Cyber Physical System) (4 Years, Bachelor of Technology)",0,0,0,60,0,60,60
"Computer Science and Engineering (Cyber Security) (4 Years, Bachelor of Technology)",0,0,0,140,8,148,148
"Computer Science and Engineering (Data Science) (4 Years, Bachelor of Technology)",0,0,0,90,0,90,90
"Computer Science and Engineering (Internet of Things, Cyber Security including Block Chain Technology ) (4 Years, Bachelor of Technology)",0,0,0,60,0,60,60
"Computer Science and Engineering (with Specialization of Data Science and Artificial Intelligence) (4 Years, B. Tech / B. Tech (Hons.))",0,0,0,30,0,30,30
"Computer Science and Engineering with Major in Artificial Intelligence (4 Years, Bachelor of Technology)",0,0,0,67,9,76,76
"Computer Science and Engineering with Specialization in Cyber Security (5 Years, Bachelor and Master of Technology (Dual Degree)) BIHAR",11,0,11,11,0,11,0
"Computer Science and Engineering with Specialization in Cyber Security (5 Years, Bachelor and Master of Technology (Dual Degree)) Other than BIHAR",11,0,11,11,0,11,0
"Computer Science and Engineering with Specialization in Data Science (5 Years, Bachelor and Master of Technology (Dual Degree)) BIHAR",12,0,12,12,0,12,0
"Computer Science and Engineering with Specialization in Data Science (5 Years, Bachelor and Master of Technology (Dual Degree)) Other than BIHAR",11,0,11,11,0,11,0
"Computer Science and Engineering with minor in AI and ML (4 Years, Bachelor of Technology)",0,0,0,60,0,60,60
"Computer Science and Engineering with specialization in Artificial Intelligence and Data Science (4 Years, Bachelor of Technology)",0,0,0,169,35,204,204
"Computer Science and Engineering with specialization in Cyber Security (4 Years, Bachelor of Technology)",0,0,0,174,24,198,198
"Computer Science and Engineering with specialization in Quantum Technologies (4 Years, Bachelor of Technology)",0,0,0,55,11,66,66
"Dairy Engineering (4 Years, Bachelor of Technology)",0,0,0,60,0,60,60
"Data Science and Artificial Intelligence (4 Years, Bachelor of Technology)",120,0,120,336,32,368,248
"Data Science and Engineering (4 Years, Bachelor of Technology)",82,8,90,32,8,40,-50
"Data Science and Engineering (4 Years, Bachelor of Technology) Other than PUNJAB",20,0,20,30,0,30,10
"Data Science and Engineering (4 Years, Bachelor of Technology) PUNJAB",20,0,20,30,0,30,10
"Design (4 Years, Bachelor of Technology)",0,0,0,20,0,20,20
"Design Engineering (4 Years, Bachelor of Technology)",0,0,0,20,0,20,20
"Digital Agriculture (4 Years, Bachelor of Technology)",0,0,0,20,0,20,20
"Earth Sciences (4 Years, Bachelor of Science)",34,9,43,34,9,43,0
"Economics (4 Years, Bachelor of Science)",164,11,175,164,11,175,0
"Economics (5 Years, Bachelor of Science and Master of Science (Dual Degree))",33,0,33,33,0,33,0
"Electrical Engineering (4 Years, Bachelor of Technology)",1642,211,1853,2248,198,2446,593
"Electrical Engineering (4 Years, Bachelor of Technology) ARUNACHAL PRADESH",16,0,16,21,0,21,5
"Electrical Engineering (4 Years, Bachelor of Technology) ASSAM",81,0,81,81,0,81,0
"Electrical Engineering (4 Years, Bachelor of Technology) BIHAR",60,0,60,58,0,58,-2
"Electrical Engineering (4 Years, Bachelor of Technology) CHHATTISGARH",57,0,57,57,0,57,0
"Electrical Engineering (4 Years, Bachelor of Technology) DELHI (NCT) CHANDIGARH (UT)",30,0,30,30,0,30,0
"Electrical Engineering (4 Years, Bachelor of Technology) GUJARAT",0,0,0,65,0,65,65
"Electrical Engineering (4 Years, Bachelor of Technology) HARYANA",54,0,54,54,0,54,0
"Electrical Engineering (4 Years, Bachelor of Technology) HIMACHAL PRADESH",62,0,62,63,0,63,1
"Electrical Engineering (4 Years, Bachelor of Technology) JHARKHAND",57,0,57,57,0,57,0
"Electrical Engineering (4 Years, Bachelor of Technology) JK JAMMU & KASHMIR (UT)",52,2,54,48,2,50,-4
"Electrical Engineering (4 Years, Bachelor of Technology) LA LADAKH (UT)",2,1,3,2,1,3,0
"Electrical Engineering (4 Years, Bachelor of Technology) MADHYA PRADESH",55,13,68,54,12,66,-2
"Electrical Engineering (4 Years, Bachelor of Technology) MANIPUR",19,0,19,19,0,19,0
"Electrical Engineering (4 Years, Bachelor of Technology) MIZORAM",16,2,18,15,2,17,-1
"Electrical Engineering (4 Years, Bachelor of Technology) ODISHA",57,0,57,57,1,58,1
"Electrical Engineering (4 Years, Bachelor of Technology) Other than ARUNACHAL PRADESH",16,0,16,21,0,21,5
"Electrical Engineering (4 Years, Bachelor of Technology) Other than ASSAM",81,0,81,81,0,81,0
"Electrical Engineering (4 Years, Bachelor of Technology) Other than BIHAR",60,0,60,58,0,58,-2
"Electrical Engineering (4 Years, Bachelor of Technology) Other than CHHATTISGARH",58,0,58,58,0,58,0
"Electrical Engineering (4 Years, Bachelor of Technology) Other than DELHI (NCT) CHANDIGARH (UT)",30,0,30,30,0,30,0
"Electrical Engineering (4 Years, Bachelor of Technology) Other than GUJARAT",0,0,0,65,0,65,65
"Electrical Engineering (4 Years, Bachelor of Technology) Other than HARYANA",54,0,54,54,0,54,0
"Electrical Engineering (4 Years, Bachelor of Technology) Other than HIMACHAL PRADESH",63,0,63,62,0,62,-1
"Electrical Engineering (4 Years, Bachelor of Technology) Other than JAMMU & KASHMIR (UT) LADAKH (UT)",54,2,56,50,2,52,-4
"Electrical Engineering (4 Years, Bachelor of Technology) Other than JHARKHAND",57,0,57,57,0,57,0
"Electrical Engineering (4 Years, Bachelor of Technology) Other than MADHYA PRADESH",54,14,68,54,12,66,-2
"Electrical Engineering (4 Years, Bachelor of Technology) Other than MANIPUR",19,0,19,19,0,19,0
"Electrical Engineering (4 Years, Bachelor of Technology) Other than MIZORAM",17,1,18,16,1,17,-1
"Electrical Engineering (4 Years, Bachelor of Technology) Other than ODISHA",56,0,56,56,0,56,0
"Electrical Engineering (4 Years, Bachelor of Technology) Other than PUNJAB",30,0,30,30,0,30,0
"Electrical Engineering (4 Years, Bachelor of Technology) Other than RAJASTHAN",59,0,59,59,0,59,0
"Electrical Engineering (4 Years, Bachelor of Technology) Other than TRIPURA",50,13,63,47,13,60,-3
"Electrical Engineering (4 Years, Bachelor of Technology) Other than UTTAR PRADESH",49,3,52,49,3,52,0
"Electrical Engineering (4 Years, Bachelor of Technology) Other than WEST BENGAL",50,0,50,101,0,101,51
"Electrical Engineering (4 Years, Bachelor of Technology) PUNJAB",30,0,30,30,0,30,0
"Electrical Engineering (4 Years, Bachelor of Technology) RAJASTHAN",58,0,58,58,0,58,0
"Electrical Engineering (4 Years, Bachelor of Technology) TRIPURA",48,14,62,46,14,60,-2
"Electrical Engineering (4 Years, Bachelor of Technology) UTTAR PRADESH",48,3,51,48,3,51,0
"Electrical Engineering (4 Years, Bachelor of Technology) WEST BENGAL",50,0,50,101,0,101,51
"Electrical Engineering (5 Years, Bachelor and Master of Technology (Dual Degree))",96,14,110,110,9,119,9
"Electrical Engineering (5 Years, Bachelor and Master of Technology (Dual Degree)) HARYANA",6,0,6,6,0,6,0
"Electrical Engineering (5 Years, Bachelor and Master of Technology (Dual Degree)) Other than HARYANA",6,0,6,6,0,6,0
"Electrical Engineering (IC Design and Technology) (4 Years, Bachelor of Technology)",21,4,25,26,4,30,5
"Electrical Engineering (Integrated Circuit Design and Technology) (4 Years, Bachelor of Technology)",0,0,0,20,0,20,20
"Electrical Engineering (Power and Automation) (4 Years, Bachelor of Technology)",61,4,65,54,0,54,-11
"Electrical Engineering with M.Tech. in Power Electronics (5 Years, Bachelor and Master of Technology (Dual Degree))",29,1,30,0,0,0,-30
"Electrical Engineering with Specialization In Power System Engineering (5 Years, Bachelor and Master of Technology (Dual Degree)) BIHAR",0,0,0,12,0,12,12
"Electrical Engineering with Specialization In Power System Engineering (5 Years, Bachelor and Master of Technology (Dual Degree)) Other than BIHAR",0,0,0,11,0,11,11
"Electrical Engineering with Specialization in Power System Engineering (5 Years, Bachelor and Master of Technology (Dual Degree)) BIHAR",12,0,12,0,0,0,-12
"Electrical Engineering with Specialization in Power System Engineering (5 Years, Bachelor and Master of Technology (Dual Degree)) Other than BIHAR",11,0,11,0,0,0,-11
"Electrical and Electronics Engineering (4 Years, Bachelor of Technology)",76,4,80,417,25,442,362
"Electrical and Electronics Engineering (4 Years, Bachelor of Technology) ANDHRA PRADESH",0,0,0,45,0,45,45
"Electrical and Electronics Engineering (4 Years, Bachelor of Technology) DAMAN & DIU (UT) DADRA & NAGAR HAVELI (UT) LAKSHADWEEP (UT)",5,0,5,5,0,5,0
"Electrical and Electronics Engineering (4 Years, Bachelor of Technology) GOA",20,0,20,20,0,20,0
"Electrical and Electronics Engineering (4 Years, Bachelor of Technology) KARNATAKA",58,0,58,58,0,58,0
"Electrical and Electronics Engineering (4 Years, Bachelor of Technology) KERALA",86,0,86,86,0,86,0
"Electrical and Electronics Engineering (4 Years, Bachelor of Technology) MAHARASHTRA",0,0,0,57,0,57,57
"Electrical and Electronics Engineering (4 Years, Bachelor of Technology) MEGHALAYA",16,0,16,16,0,16,0
"Electrical and Electronics Engineering (4 Years, Bachelor of Technology) NAGALAND",15,0,15,15,0,15,0
"Electrical and Electronics Engineering (4 Years, Bachelor of Technology) Other than ANDHRA PRADESH",0,0,0,45,0,45,45
"Electrical and Electronics Engineering (4 Years, Bachelor of Technology) Other than GOA DAMAN & DIU (UT) DADRA & NAGAR HAVELI (UT) LAKSHADWEEP (UT)",25,0,25,25,0,25,0
"Electrical and Electronics Engineering (4 Years, Bachelor of Technology) Other than KARNATAKA",58,0,58,58,0,58,0
"Electrical and Electronics Engineering (4 Years, Bachelor of Technology) Other than KERALA",86,0,86,86,0,86,0
"Electrical and Electronics Engineering (4 Years, Bachelor of Technology) Other than MAHARASHTRA",0,0,0,58,0,58,58
"Electrical and Electronics Engineering (4 Years, Bachelor of Technology) Other than MEGHALAYA",17,0,17,17,0,17,0
"Electrical and Electronics Engineering (4 Years, Bachelor of Technology) Other than NAGALAND",18,0,18,18,0,18,0
"Electrical and Electronics Engineering (4 Years, Bachelor of Technology) Other than PUDUCHERRY (UT) ANDAMAN & NICOBAR ISLANDS (UT)",30,0,30,30,0,30,0
"Electrical and Electronics Engineering (4 Years, Bachelor of Technology) Other than SIKKIM",15,0,15,15,0,15,0
"Electrical and Electronics Engineering (4 Years, Bachelor of Technology) Other than TAMIL NADU",58,0,58,58,0,58,0
"Electrical and Electronics Engineering (4 Years, Bachelor of Technology) Other than TELANGANA",0,0,0,65,0,65,65
"Electrical and Electronics Engineering (4 Years, Bachelor of Technology) Other than UTTARAKHAND",14,4,18,18,0,18,0
"Electrical and Electronics Engineering (4 Years, Bachelor of Technology) PUDUCHERRY (UT) ANDAMAN & NICOBAR ISLANDS (UT)",30,0,30,30,0,30,0
"Electrical and Electronics Engineering (4 Years, Bachelor of Technology) SIKKIM",15,0,15,15,0,15,0
"Electrical and Electronics Engineering (4 Years, Bachelor of Technology) TAMIL NADU",58,0,58,58,0,58,0
"Electrical and Electronics Engineering (4 Years, Bachelor of Technology) TELANGANA",0,0,0,65,0,65,65
"Electrical and Electronics Engineering (4 Years, Bachelor of Technology) UTTARAKHAND",14,4,18,18,0,18,0
"Electronic Engineering (4 Years, Bachelor of Technology)",0,0,0,60,0,60,60
"Electronics Engineering (4 Years, Bachelor of Technology)",123,10,133,185,20,205,72
"Electronics Engineering (VLSI Design and Technology) (4 Years, Bachelor of Technology)",0,0,0,27,0,27,27
"Electronics Engineering (VLSI Design and Technology) (4 Years, Bachelor of Technology) BIHAR",0,0,0,40,0,40,40
"Electronics Engineering (VLSI Design and Technology) (4 Years, Bachelor of Technology) Other than BIHAR",0,0,0,40,0,40,40
"Electronics and Communication Engineering (4 Years, Bachelor of Technology)",490,36,526,3583,267,3850,3324
"Electronics and Communication Engineering (4 Years, Bachelor of Technology) ANDHRA PRADESH",0,0,0,45,0,45,45
"Electronics and Communication Engineering (4 Years, Bachelor of Technology) ARUNACHAL PRADESH",16,0,16,21,0,21,5
"Electronics and Communication Engineering (4 Years, Bachelor of Technology) ASSAM",81,0,81,81,0,81,0
"Electronics and Communication Engineering (4 Years, Bachelor of Technology) BIHAR",79,0,79,50,0,50,-29
"Electronics and Communication Engineering (4 Years, Bachelor of Technology) CHHATTISGARH",57,0,57,57,0,57,0
"Electronics and Communication Engineering (4 Years, Bachelor of Technology) DAMAN & DIU (UT) DADRA & NAGAR HAVELI (UT) LAKSHADWEEP (UT)",5,0,5,5,0,5,0
"Electronics and Communication Engineering (4 Years, Bachelor of Technology) DELHI (NCT) CHANDIGARH (UT)",30,0,30,30,0,30,0
"Electronics and Communication Engineering (4 Years, Bachelor of Technology) GOA",20,0,20,20,0,20,0
"Electronics and Communication Engineering (4 Years, Bachelor of Technology) GUJARAT",0,0,0,70,0,70,70
"Electronics and Communication Engineering (4 Years, Bachelor of Technology) HARYANA",54,0,54,54,0,54,0
"Electronics and Communication Engineering (4 Years, Bachelor of Technology) HIMACHAL PRADESH",59,0,59,58,0,58,-1
"Electronics and Communication Engineering (4 Years, Bachelor of Technology) JHARKHAND",58,0,58,58,0,58,0
"Electronics and Communication Engineering (4 Years, Bachelor of Technology) JK JAMMU & KASHMIR (UT)",47,3,50,44,3,47,-3
"Electronics and Communication Engineering (4 Years, Bachelor of Technology) KARNATAKA",58,0,58,58,0,58,0
"Electronics and Communication Engineering (4 Years, Bachelor of Technology) KERALA",86,1,87,86,0,86,-1
"Electronics and Communication Engineering (4 Years, Bachelor of Technology) LA LADAKH (UT)",2,1,3,2,1,3,0
"Electronics and Communication Engineering (4 Years, Bachelor of Technology) MADHYA PRADESH",69,18,87,69,18,87,0
"Electronics and Communication Engineering (4 Years, Bachelor of Technology) MAHARASHTRA",0,0,0,57,0,57,57
"Electronics and Communication Engineering (4 Years, Bachelor of Technology) MANIPUR",19,0,19,19,0,19,0
"Electronics and Communication Engineering (4 Years, Bachelor of Technology) MEGHALAYA",16,0,16,16,0,16,0
"Electronics and Communication Engineering (4 Years, Bachelor of Technology) MIZORAM",15,3,18,16,1,17,-1
"Electronics and Communication Engineering (4 Years, Bachelor of Technology) NAGALAND",15,0,15,15,0,15,0
"Electronics and Communication Engineering (4 Years, Bachelor of Technology) ODISHA",28,0,28,28,0,28,0
"Electronics and Communication Engineering (4 Years, Bachelor of Technology) Other than ANDHRA PRADESH",0,0,0,45,0,45,45
"Electronics and Communication Engineering (4 Years, Bachelor of Technology) Other than ARUNACHAL PRADESH",16,0,16,21,0,21,5
"Electronics and Communication Engineering (4 Years, Bachelor of Technology) Other than ASSAM",81,0,81,81,0,81,0
"Electronics and Communication Engineering (4 Years, Bachelor of Technology) Other than BIHAR",79,0,79,50,0,50,-29
"Electronics and Communication Engineering (4 Years, Bachelor of Technology) Other than CHHATTISGARH",57,0,57,57,0,57,0
"Electronics and Communication Engineering (4 Years, Bachelor of Technology) Other than DELHI (NCT) CHANDIGARH (UT)",30,0,30,30,0,30,0
"Electronics and Communication Engineering (4 Years, Bachelor of Technology) Other than GOA DAMAN & DIU (UT) DADRA & NAGAR HAVELI (UT) LAKSHADWEEP (UT)",25,0,25,25,0,25,0
"Electronics and Communication Engineering (4 Years, Bachelor of Technology) Other than GUJARAT",0,0,0,70,0,70,70
"Electronics and Communication Engineering (4 Years, Bachelor of Technology) Other than HARYANA",54,0,54,54,0,54,0
"Electronics and Communication Engineering (4 Years, Bachelor of Technology) Other than HIMACHAL PRADESH",58,0,58,59,0,59,1
"Electronics and Communication Engineering (4 Years, Bachelor of Technology) Other than JAMMU & KASHMIR (UT) LADAKH (UT)",52,1,53,49,1,50,-3
"Electronics and Communication Engineering (4 Years, Bachelor of Technology) Other than JHARKHAND",58,0,58,58,0,58,0
"Electronics and Communication Engineering (4 Years, Bachelor of Technology) Other than KARNATAKA",58,0,58,58,0,58,0
"Electronics and Communication Engineering (4 Years, Bachelor of Technology) Other than KERALA",86,0,86,86,1,87,1
"Electronics and Communication Engineering (4 Years, Bachelor of Technology) Other than MADHYA PRADESH",69,17,86,69,17,86,0
"Electronics and Communication Engineering (4 Years, Bachelor of Technology) Other than MAHARASHTRA",0,0,0,58,0,58,58
"Electronics and Communication Engineering (4 Years, Bachelor of Technology) Other than MANIPUR",19,0,19,19,0,19,0
"Electronics and Communication Engineering (4 Years, Bachelor of Technology) Other than MEGHALAYA",17,0,17,17,0,17,0
"Electronics and Communication Engineering (4 Years, Bachelor of Technology) Other than MIZORAM",16,2,18,15,2,17,-1
"Electronics and Communication Engineering (4 Years, Bachelor of Technology) Other than NAGALAND",18,1,19,18,1,19,0
"Electronics and Communication Engineering (4 Years, Bachelor of Technology) Other than ODISHA",28,0,28,28,0,28,0
"Electronics and Communication Engineering (4 Years, Bachelor of Technology) Other than PUDUCHERRY (UT) ANDAMAN & NICOBAR ISLANDS (UT)",30,0,30,30,0,30,0
"Electronics and Communication Engineering (4 Years, Bachelor of Technology) Other than PUNJAB",43,0,43,42,0,42,-1
"Electronics and Communication Engineering (4 Years, Bachelor of Technology) Other than RAJASTHAN",58,0,58,58,0,58,0
"Electronics and Communication Engineering (4 Years, Bachelor of Technology) Other than SIKKIM",15,0,15,15,0,15,0
"Electronics and Communication Engineering (4 Years, Bachelor of Technology) Other than TAMIL NADU",59,0,59,59,0,59,0
"Electronics and Communication Engineering (4 Years, Bachelor of Technology) Other than TELANGANA",50,0,50,50,0,50,0
"Electronics and Communication Engineering (4 Years, Bachelor of Technology) Other than TRIPURA",51,13,64,47,13,60,-4
"Electronics and Communication Engineering (4 Years, Bachelor of Technology) Other than UTTAR PRADESH",86,5,91,86,5,91,0
"Electronics and Communication Engineering (4 Years, Bachelor of Technology) Other than UTTARAKHAND",17,3,20,20,0,20,0
"Electronics and Communication Engineering (4 Years, Bachelor of Technology) Other than WEST BENGAL",48,0,48,48,0,48,0
"Electronics and Communication Engineering (4 Years, Bachelor of Technology) PUDUCHERRY (UT) ANDAMAN & NICOBAR ISLANDS (UT)",30,0,30,30,0,30,0
"Electronics and Communication Engineering (4 Years, Bachelor of Technology) PUNJAB",43,0,43,43,0,43,0
"Electronics and Communication Engineering (4 Years, Bachelor of Technology) RAJASTHAN",59,0,59,59,0,59,0
"Electronics and Communication Engineering (4 Years, Bachelor of Technology) SIKKIM",15,0,15,15,0,15,0
"Electronics and Communication Engineering (4 Years, Bachelor of Technology) TAMIL NADU",58,0,58,58,0,58,0
"Electronics and Communication Engineering (4 Years, Bachelor of Technology) TELANGANA",50,0,50,50,0,50,0
"Electronics and Communication Engineering (4 Years, Bachelor of Technology) TRIPURA",49,15,64,45,15,60,-4
"Electronics and Communication Engineering (4 Years, Bachelor of Technology) UTTAR PRADESH",87,4,91,87,4,91,0
"Electronics and Communication Engineering (4 Years, Bachelor of Technology) UTTARAKHAND",15,5,20,20,0,20,0
"Electronics and Communication Engineering (4 Years, Bachelor of Technology) WEST BENGAL",49,0,49,49,0,49,0
"Electronics and Communication Engineering (5 Years, Bachelor and Master of Technology (Dual Degree))",0,0,0,20,1,21,21
"Electronics and Communication Engineering (5 Years, Bachelor and Master of Technology (Dual Degree)) HARYANA",6,0,6,6,0,6,0
"Electronics and Communication Engineering (5 Years, Bachelor and Master of Technology (Dual Degree)) HIMACHAL PRADESH",14,0,14,14,0,14,0
"Electronics and Communication Engineering (5 Years, Bachelor and Master of Technology (Dual Degree)) Other than HARYANA",6,0,6,6,0,6,0
"Electronics and Communication Engineering (5 Years, Bachelor and Master of Technology (Dual Degree)) Other than HIMACHAL PRADESH",14,0,14,14,0,14,0
"Electronics and Communication Engineering (Avionics) (4 Years, Bachelor of Technology)",0,0,0,120,0,120,120
"Electronics and Communication Engineering (Internet of Things) (4 Years, Bachelor of Technology)",0,0,0,72,0,72,72
"Electronics and Communication Engineering (VLSI Design and Technology) (4 Years, Bachelor of Technology) Other than TELANGANA",20,0,20,20,0,20,0
"Electronics and Communication Engineering (VLSI Design and Technology) (4 Years, Bachelor of Technology) TELANGANA",20,0,20,20,0,20,0
"Electronics and Communication Engineering (VLSI Design) (4 Years, Bachelor of Technology)",0,0,0,37,0,37,37
"Electronics and Communication Engineering (with Specialization of Embedded Systems and Internet of Things) (4 Years, B. Tech / B. Tech (Hons.))",0,0,0,30,0,30,30
"Electronics and Communication Engineering with Specialization in Microelectronics and VLSI System Design (5 Years, Bachelor and Master of Technology (Dual Degree)) BIHAR",11,0,11,11,0,11,0
"Electronics and Communication Engineering with Specialization in Microelectronics and VLSI System Design (5 Years, Bachelor and Master of Technology (Dual Degree)) Other than BIHAR",11,0,11,11,0,11,0
"Electronics and Communication Engineering with specialization in Design and Manufacturing (4 Years, Bachelor of Technology)",0,0,0,60,7,67,67
"Electronics and Communication Engineering with specialization in VLSI and Embedded Systems (4 Years, Bachelor of Technology)",0,0,0,110,22,132,132
"Electronics and Electrical Communication Engineering (4 Years, Bachelor of Technology)",127,23,150,127,23,150,0
"Electronics and Electrical Engineering (4 Years, Bachelor of Technology)",52,10,62,52,10,62,0
"Electronics and Instrumentation Engineering (4 Years, Bachelor of Technology)",0,0,0,11,0,11,11
"Electronics and Instrumentation Engineering (4 Years, Bachelor of Technology) ASSAM",50,0,50,50,0,50,0
"Electronics and Instrumentation Engineering (4 Years, Bachelor of Technology) NAGALAND",15,0,15,15,0,15,0
"Electronics and Instrumentation Engineering (4 Years, Bachelor of Technology) ODISHA",28,0,28,28,0,28,0
"Electronics and Instrumentation Engineering (4 Years, Bachelor of Technology) Other than ASSAM",50,0,50,50,0,50,0
"Electronics and Instrumentation Engineering (4 Years, Bachelor of Technology) Other than NAGALAND",18,0,18,18,1,19,1
"Electronics and Instrumentation Engineering (4 Years, Bachelor of Technology) Other than ODISHA",28,0,28,28,0,28,0
"Electronics and Instrumentation Engineering (4 Years, Bachelor of Technology) Other than TRIPURA",30,8,38,36,9,45,7
"Electronics and Instrumentation Engineering (4 Years, Bachelor of Technology) TRIPURA",29,8,37,35,10,45,8
"Electronics and Telecommunication Engineering (4 Years, Bachelor of Technology)",0,0,0,42,0,42,42
"Electronics and Telecommunication Engineering (4 Years, Bachelor of Technology) Other than WEST BENGAL",0,0,0,35,0,35,35
"Electronics and Telecommunication Engineering (4 Years, Bachelor of Technology) WEST BENGAL",0,0,0,35,0,35,35
"Electronics and VLSI Engineering (4 Years, Bachelor of Technology) GUJARAT",0,0,0,30,0,30,30
"Electronics and VLSI Engineering (4 Years, Bachelor of Technology) Other than GUJARAT",0,0,0,30,0,30,30
"Electronics and VLSI Engineering (4 Years, Bachelor of Technology) Other than PUNJAB",15,0,15,15,0,15,0
"Electronics and VLSI Engineering (4 Years, Bachelor of Technology) PUNJAB",15,0,15,15,0,15,0
"Energy Engineering (4 Years, Bachelor of Technology)",121,7,128,141,6,147,19
"Energy Engineering (4 Years, Bachelor of Technology) KERALA",0,0,0,20,0,20,20
"Energy Engineering (4 Years, Bachelor of Technology) Other than KERALA",0,0,0,20,0,20,20
"Energy and Electrical Vehicle Engineering (4 Years, Bachelor of Technology) MADHYA PRADESH",0,0,0,12,3,15,15
"Energy and Electrical Vehicle Engineering (4 Years, Bachelor of Technology) Other than MADHYA PRADESH",0,0,0,12,3,15,15
"Engineering Design (5 Years, Bachelor and Master of Technology (Dual Degree))",71,3,74,63,3,66,-8
"Engineering Physics (4 Years, Bachelor of Technology)",487,35,522,567,35,602,80
"Engineering Physics (4 Years, Bachelor of Technology) GUJARAT",0,0,0,15,0,15,15
"Engineering Physics (4 Years, Bachelor of Technology) HIMACHAL PRADESH",25,0,25,25,0,25,0
"Engineering Physics (4 Years, Bachelor of Technology) KERALA",18,0,18,19,0,19,1
"Engineering Physics (4 Years, Bachelor of Technology) Other than GUJARAT",0,0,0,15,0,15,15
"Engineering Physics (4 Years, Bachelor of Technology) Other than HIMACHAL PRADESH",25,0,25,25,0,25,0
"Engineering Physics (4 Years, Bachelor of Technology) Other than KERALA",19,0,19,18,0,18,-1
"Engineering Physics (5 Years, Bachelor and Master of Technology (Dual Degree))",27,1,28,0,0,0,-28
"Engineering Physics (5 Years, Bachelor and Master of Technology (Dual Degree)) Other than TRIPURA",13,0,13,13,0,13,0
"Engineering Physics (5 Years, Bachelor and Master of Technology (Dual Degree)) TRIPURA",12,0,12,12,0,12,0
"Engineering Science (4 Years, Bachelor of Technology)",33,7,40,33,7,40,0
"Engineering and Computational Mechanics (4 Years, Bachelor of Technology)",40,0,40,40,0,40,0
"Engineering and Computational Mechanics (4 Years, Bachelor of Technology) JHARKHAND",15,0,15,15,0,15,0
"Engineering and Computational Mechanics (4 Years, Bachelor of Technology) Other than JHARKHAND",15,0,15,15,0,15,0
"Engineering and Computational Mechanics (4 Years, Bachelor of Technology) Other than UTTAR PRADESH",15,0,15,15,0,15,0
"Engineering and Computational Mechanics (4 Years, Bachelor of Technology) UTTAR PRADESH",15,0,15,15,0,15,0
"Environmental Engineering (4 Years, Bachelor of Technology)",47,1,48,47,1,48,0
"Environmental Science and Engineering (4 Years, Bachelor of Technology)",37,9,46,37,9,46,0
"Exploration Geophysics (4 Years, Bachelor of Science)",45,0,45,45,0,45,0
"Fashion and Apparel Engineering (4 Years, Bachelor of Technology)",0,0,0,60,0,60,60
"Food Engineering and Technology (4 Years, Bachelor of Technology)",0,0,0,119,4,123,123
"Food Process Engineering (4 Years, Bachelor of Technology) ODISHA",15,0,15,15,0,15,0
"Food Process Engineering (4 Years, Bachelor of Technology) Other than ODISHA",15,0,15,15,1,16,1
"Food Technology (4 Years, Bachelor of Technology)",0,0,0,174,0,174,174
"Food Technology and Management (4 Years, Bachelor of Technology)",0,0,0,100,0,100,100
"Geological Technology (5 Years, Integrated Master of Technology)",38,0,38,38,0,38,0
"Geophysical Technology (5 Years, Integrated Master of Technology)",38,3,41,38,3,41,0
"Handloom and Textile Technology (4 Years, Bachelor of Technology)",0,0,0,63,0,63,63
"Industrial Chemistry (4 Years, Bachelor of Technology)",22,3,25,51,3,54,29
"Industrial Chemistry (4 Years, Bachelor of Technology) GUJARAT",0,0,0,15,0,15,15
"Industrial Chemistry (4 Years, Bachelor of Technology) Other than GUJARAT",0,0,0,15,0,15,15
"Industrial Chemistry (5 Years, Bachelor and Master of Technology (Dual Degree))",21,0,21,0,0,0,-21
"Industrial Design (4 Years, Bachelor of Technology) ODISHA",14,0,14,14,0,14,0
"Industrial Design (4 Years, Bachelor of Technology) Other than ODISHA",14,0,14,14,0,14,0
"Industrial Engineering and Operations Research (4 Years, Bachelor of Technology)",36,4,40,36,4,40,0
"Industrial Internet of Things (4 Years, Bachelor of Technology) HARYANA",30,0,30,30,0,30,0
"Industrial Internet of Things (4 Years, Bachelor of Technology) Other than HARYANA",30,0,30,30,0,30,0
"Industrial and Production Engineering (4 Years, Bachelor of Technology)",0,0,0,64,0,64,64
"Industrial and Production Engineering (4 Years, Bachelor of Technology) Other than PUNJAB",37,0,37,35,0,35,-2
"Industrial and Production Engineering (4 Years, Bachelor of Technology) PUNJAB",38,0,38,35,0,35,-3
"Industrial and Systems Engineering (4 Years, Bachelor of Technology)",63,9,72,63,9,72,0
"Information Technology (4 Years, Bachelor of Technology)",0,0,0,724,8,732,732
"Information Technology (4 Years, Bachelor of Technology) CHHATTISGARH",57,0,57,57,0,57,0
"Information Technology (4 Years, Bachelor of Technology) HARYANA",30,0,30,30,0,30,0
"Information Technology (4 Years, Bachelor of Technology) JK JAMMU & KASHMIR (UT)",41,1,42,61,1,62,20
"Information Technology (4 Years, Bachelor of Technology) KARNATAKA",38,0,38,38,0,38,0
"Information Technology (4 Years, Bachelor of Technology) LA LADAKH (UT)",2,0,2,3,0,3,1
"Information Technology (4 Years, Bachelor of Technology) Other than CHHATTISGARH",57,0,57,57,0,57,0
"Information Technology (4 Years, Bachelor of Technology) Other than HARYANA",30,0,30,30,0,30,0
"Information Technology (4 Years, Bachelor of Technology) Other than JAMMU & KASHMIR (UT) LADAKH (UT)",41,2,43,62,2,64,21
"Information Technology (4 Years, Bachelor of Technology) Other than KARNATAKA",38,0,38,38,0,38,0
"Information Technology (4 Years, Bachelor of Technology) Other than PUNJAB",60,0,60,60,0,60,0
"Information Technology (4 Years, Bachelor of Technology) Other than WEST BENGAL",0,0,0,51,0,51,51
"Information Technology (4 Years, Bachelor of Technology) PUNJAB",60,0,60,60,0,60,0
"Information Technology (4 Years, Bachelor of Technology) WEST BENGAL",0,0,0,51,0,51,51
"Information Technology-Business Informatics (4 Years, Bachelor of Technology)",0,0,0,40,0,40,40
"Instrumentation Engineering (4 Years, Bachelor of Technology)",41,3,44,44,3,47,3
"Instrumentation and Biomedical Engineering (4 Years, Bachelor of Technology)",0,0,0,40,0,40,40
"Instrumentation and Control Engineering (4 Years, Bachelor of Technology)",0,0,0,47,0,47,47
"Instrumentation and Control Engineering (4 Years, Bachelor of Technology) Other than PUNJAB",50,0,50,45,0,45,-5
"Instrumentation and Control Engineering (4 Years, Bachelor of Technology) Other than TAMIL NADU",59,0,59,59,0,59,0
"Instrumentation and Control Engineering (4 Years, Bachelor of Technology) PUNJAB",50,0,50,45,0,45,-5
"Instrumentation and Control Engineering (4 Years, Bachelor of Technology) TAMIL NADU",58,0,58,58,0,58,0
"Integrated B. Tech.(IT) and M. Tech (IT) (5 Years, Integrated B. Tech. and M. Tech.)",0,0,0,90,0,90,90
"Integrated B. Tech.(IT) and MBA (5 Years, Integrated B. Tech. and MBA)",0,0,0,60,0,60,60
"Integrated Circuit Design & Technology (4 Years, Bachelor of Technology)",24,6,30,24,6,30,0
"Interdisciplinary Sciences (5 Years, Bachelor of Science and Master of Science (Dual Degree))",57,3,60,57,3,60,0
"Life Science (5 Years, Integrated Master of Science) ODISHA",10,0,10,10,0,10,0
"Life Science (5 Years, Integrated Master of Science) Other than ODISHA",10,0,10,10,0,10,0
"Manufacturing Science and Engineering (4 Years, Bachelor of Technology)",55,11,66,55,11,66,0
"Material Science and Engineering (5 Years, Bachelor and Master of Technology (Dual Degree)) BIHAR",5,0,5,6,0,6,1
"Material Science and Engineering (5 Years, Bachelor and Master of Technology (Dual Degree)) Other than BIHAR",5,0,5,6,0,6,1
"Materials Engineering (4 Years, Bachelor of Technology)",153,17,170,152,18,170,0
"Materials Engineering (4 Years, Bachelor of Technology) Other than UTTAR PRADESH",15,0,15,15,0,15,0
"Materials Engineering (4 Years, Bachelor of Technology) UTTAR PRADESH",15,0,15,15,0,15,0
"Materials Engineering (5 Years, Integrated Master of Technology)",0,0,0,60,0,60,60
"Materials Science and Engineering (4 Years, Bachelor of Technology)",68,17,85,68,17,85,0
"Materials Science and Engineering (4 Years, Bachelor of Technology) HIMACHAL PRADESH",20,0,20,20,0,20,0
"Materials Science and Engineering (4 Years, Bachelor of Technology) KERALA",15,0,15,15,0,15,0
"Materials Science and Engineering (4 Years, Bachelor of Technology) Other than HIMACHAL PRADESH",20,0,20,20,0,20,0
"Materials Science and Engineering (4 Years, Bachelor of Technology) Other than KERALA",15,0,15,15,0,15,0
"Materials Science and Metallurgical Engineering (4 Years, Bachelor of Technology)",49,6,55,59,6,65,10
"Materials Science and Metallurgical Engineering (4 Years, Bachelor of Technology) MADHYA PRADESH",31,8,39,29,7,36,-3
"Materials Science and Metallurgical Engineering (4 Years, Bachelor of Technology) Other than MADHYA PRADESH",31,8,39,28,7,35,-4
"Materials Science and Technology (4 Years, Bachelor of Technology)",0,0,0,28,0,28,28
"Materials Science and Technology (5 Years, Bachelor and Master of Technology (Dual Degree))",28,0,28,0,0,0,-28
"Mathematics & Computing (5 Years, Bachelor of Science and Master of Science (Dual Degree))",44,5,49,44,5,49,0
"Mathematics & Computing (5 Years, Bachelor of Science and Master of Science (Dual Degree)) Other than TRIPURA",13,0,13,20,0,20,7
"Mathematics & Computing (5 Years, Bachelor of Science and Master of Science (Dual Degree)) TRIPURA",12,0,12,20,0,20,8
"Mathematics (5 Years, Integrated Master of Science)",0,0,0,10,0,10,10
"Mathematics (5 Years, Integrated Master of Science) GUJARAT",0,0,0,25,0,25,25
"Mathematics (5 Years, Integrated Master of Science) ODISHA",12,0,12,12,0,12,0
"Mathematics (5 Years, Integrated Master of Science) Other than GUJARAT",0,0,0,25,0,25,25
"Mathematics (5 Years, Integrated Master of Science) Other than ODISHA",13,0,13,13,0,13,0
"Mathematics (5 Years, Integrated Master of Science) Other than TELANGANA",0,0,0,10,0,10,10
"Mathematics (5 Years, Integrated Master of Science) TELANGANA",0,0,0,10,0,10,10
"Mathematics and Computing (4 Years, Bachelor of Science)",69,0,69,69,0,69,0
"Mathematics and Computing (4 Years, Bachelor of Technology)",442,24,466,754,24,778,312
"Mathematics and Computing (4 Years, Bachelor of Technology) GUJARAT",0,0,0,15,0,15,15
"Mathematics and Computing (4 Years, Bachelor of Technology) HARYANA",29,0,29,29,0,29,0
"Mathematics and Computing (4 Years, Bachelor of Technology) HIMACHAL PRADESH",25,0,25,25,0,25,0
"Mathematics and Computing (4 Years, Bachelor of Technology) MIZORAM",5,0,5,5,0,5,0
"Mathematics and Computing (4 Years, Bachelor of Technology) Other than GUJARAT",0,0,0,15,0,15,15
"Mathematics and Computing (4 Years, Bachelor of Technology) Other than HARYANA",28,0,28,28,0,28,0
"Mathematics and Computing (4 Years, Bachelor of Technology) Other than HIMACHAL PRADESH",25,0,25,25,0,25,0
"Mathematics and Computing (4 Years, Bachelor of Technology) Other than MIZORAM",5,0,5,5,0,5,0
"Mathematics and Computing (4 Years, Bachelor of Technology) Other than PUNJAB",20,0,20,25,0,25,5
"Mathematics and Computing (4 Years, Bachelor of Technology) Other than TELANGANA",15,0,15,15,0,15,0
"Mathematics and Computing (4 Years, Bachelor of Technology) PUNJAB",20,0,20,25,0,25,5
"Mathematics and Computing (4 Years, Bachelor of Technology) TELANGANA",15,0,15,15,0,15,0
"Mathematics and Computing (5 Years, Bachelor and Master of Technology (Dual Degree))",82,3,85,33,0,33,-52
"Mathematics and Computing (5 Years, Integrated Master of Science)",0,0,0,105,9,114,114
"Mathematics and Computing Technology (5 Years, Bachelor and Master of Technology (Dual Degree)) BIHAR",5,0,5,6,0,6,1
"Mathematics and Computing Technology (5 Years, Bachelor and Master of Technology (Dual Degree)) Other than BIHAR",5,0,5,6,0,6,1
"Mathematics and Data Science (5 Years, Bachelor and Master of Technology (Dual Degree)) MADHYA PRADESH",12,3,15,12,3,15,0
"Mathematics and Data Science (5 Years, Bachelor and Master of Technology (Dual Degree)) Other than MADHYA PRADESH",12,3,15,12,3,15,0
"Mathematics and Scientific Computing (4 Years, Bachelor of Science)",51,13,64,51,13,64,0
"Mathematics and Scientific Computing (4 Years, Bachelor of Technology)",0,0,0,60,0,60,60
"Mechanical Engineering (4 Years, Bachelor of Technology)",1963,312,2275,3006,337,3343,1068
"Mechanical Engineering (4 Years, Bachelor of Technology) ANDHRA PRADESH",0,0,0,30,0,30,30
"Mechanical Engineering (4 Years, Bachelor of Technology) ARUNACHAL PRADESH",16,0,16,21,0,21,5
"Mechanical Engineering (4 Years, Bachelor of Technology) ASSAM",80,0,80,80,0,80,0
"Mechanical Engineering (4 Years, Bachelor of Technology) BIHAR",60,0,60,58,1,59,-1
"Mechanical Engineering (4 Years, Bachelor of Technology) CHHATTISGARH",58,0,58,58,0,58,0
"Mechanical Engineering (4 Years, Bachelor of Technology) DAMAN & DIU (UT) DADRA & NAGAR HAVELI (UT) LAKSHADWEEP (UT)",4,0,4,4,0,4,0
"Mechanical Engineering (4 Years, Bachelor of Technology) DELHI (NCT) CHANDIGARH (UT)",20,0,20,20,0,20,0
"Mechanical Engineering (4 Years, Bachelor of Technology) GOA",15,0,15,15,0,15,0
"Mechanical Engineering (4 Years, Bachelor of Technology) GUJARAT",0,0,0,130,0,130,130
"Mechanical Engineering (4 Years, Bachelor of Technology) HARYANA",54,0,54,54,0,54,0
"Mechanical Engineering (4 Years, Bachelor of Technology) HIMACHAL PRADESH",62,0,62,63,0,63,1
"Mechanical Engineering (4 Years, Bachelor of Technology) JHARKHAND",58,0,58,58,0,58,0
"Mechanical Engineering (4 Years, Bachelor of Technology) JK JAMMU & KASHMIR (UT)",52,3,55,47,3,50,-5
"Mechanical Engineering (4 Years, Bachelor of Technology) KARNATAKA",87,0,87,87,0,87,0
"Mechanical Engineering (4 Years, Bachelor of Technology) KERALA",85,18,103,86,16,102,-1
"Mechanical Engineering (4 Years, Bachelor of Technology) LA LADAKH (UT)",2,1,3,2,1,3,0
"Mechanical Engineering (4 Years, Bachelor of Technology) MADHYA PRADESH",86,21,107,76,16,92,-15
"Mechanical Engineering (4 Years, Bachelor of Technology) MAHARASHTRA",0,0,0,57,0,57,57
"Mechanical Engineering (4 Years, Bachelor of Technology) MANIPUR",19,0,19,19,0,19,0
"Mechanical Engineering (4 Years, Bachelor of Technology) MEGHALAYA",17,0,17,17,0,17,0
"Mechanical Engineering (4 Years, Bachelor of Technology) MIZORAM",17,1,18,16,1,17,-1
"Mechanical Engineering (4 Years, Bachelor of Technology) NAGALAND",15,0,15,15,0,15,0
"Mechanical Engineering (4 Years, Bachelor of Technology) ODISHA",57,0,57,57,0,57,0
"Mechanical Engineering (4 Years, Bachelor of Technology) Other than ANDHRA PRADESH",0,0,0,30,0,30,30
"Mechanical Engineering (4 Years, Bachelor of Technology) Other than ARUNACHAL PRADESH",16,0,16,21,0,21,5
"Mechanical Engineering (4 Years, Bachelor of Technology) Other than ASSAM",81,0,81,81,0,81,0
"Mechanical Engineering (4 Years, Bachelor of Technology) Other than BIHAR",60,0,60,58,0,58,-2
"Mechanical Engineering (4 Years, Bachelor of Technology) Other than CHHATTISGARH",57,0,57,57,0,57,0
"Mechanical Engineering (4 Years, Bachelor of Technology) Other than DELHI (NCT) CHANDIGARH (UT)",20,0,20,20,0,20,0
"Mechanical Engineering (4 Years, Bachelor of Technology) Other than GOA DAMAN & DIU (UT) DADRA & NAGAR HAVELI (UT) LAKSHADWEEP (UT)",18,0,18,18,0,18,0
"Mechanical Engineering (4 Years, Bachelor of Technology) Other than GUJARAT",0,0,0,130,0,130,130
"Mechanical Engineering (4 Years, Bachelor of Technology) Other than HARYANA",54,0,54,54,0,54,0
"Mechanical Engineering (4 Years, Bachelor of Technology) Other than HIMACHAL PRADESH",63,0,63,62,0,62,-1
"Mechanical Engineering (4 Years, Bachelor of Technology) Other than JAMMU & KASHMIR (UT) LADAKH (UT)",56,3,59,49,3,52,-7
"Mechanical Engineering (4 Years, Bachelor of Technology) Other than JHARKHAND",57,0,57,57,0,57,0
"Mechanical Engineering (4 Years, Bachelor of Technology) Other than KARNATAKA",87,0,87,87,1,88,1
"Mechanical Engineering (4 Years, Bachelor of Technology) Other than KERALA",85,18,103,86,17,103,0
"Mechanical Engineering (4 Years, Bachelor of Technology) Other than MADHYA PRADESH",86,21,107,76,16,92,-15
"Mechanical Engineering (4 Years, Bachelor of Technology) Other than MAHARASHTRA",0,0,0,58,0,58,58
"Mechanical Engineering (4 Years, Bachelor of Technology) Other than MANIPUR",19,0,19,19,0,19,0
"Mechanical Engineering (4 Years, Bachelor of Technology) Other than MEGHALAYA",16,0,16,16,0,16,0
"Mechanical Engineering (4 Years, Bachelor of Technology) Other than MIZORAM",17,1,18,16,1,17,-1
"Mechanical Engineering (4 Years, Bachelor of Technology) Other than NAGALAND",18,1,19,18,0,18,-1
"Mechanical Engineering (4 Years, Bachelor of Technology) Other than ODISHA",56,0,56,56,0,56,0
"Mechanical Engineering (4 Years, Bachelor of Technology) Other than PUDUCHERRY (UT) ANDAMAN & NICOBAR ISLANDS (UT)",25,0,25,25,0,25,0
"Mechanical Engineering (4 Years, Bachelor of Technology) Other than PUNJAB",55,0,55,55,0,55,0
"Mechanical Engineering (4 Years, Bachelor of Technology) Other than RAJASTHAN",57,0,57,57,0,57,0
"Mechanical Engineering (4 Years, Bachelor of Technology) Other than SIKKIM",15,0,15,15,0,15,0
"Mechanical Engineering (4 Years, Bachelor of Technology) Other than TAMIL NADU",59,0,59,59,0,59,0
"Mechanical Engineering (4 Years, Bachelor of Technology) Other than TELANGANA",65,0,65,65,0,65,0
"Mechanical Engineering (4 Years, Bachelor of Technology) Other than TRIPURA",50,13,63,47,13,60,-3
"Mechanical Engineering (4 Years, Bachelor of Technology) Other than UTTAR PRADESH",77,4,81,77,4,81,0
"Mechanical Engineering (4 Years, Bachelor of Technology) Other than UTTARAKHAND",14,4,18,18,0,18,0
"Mechanical Engineering (4 Years, Bachelor of Technology) Other than WEST BENGAL",93,0,93,144,0,144,51
"Mechanical Engineering (4 Years, Bachelor of Technology) PUDUCHERRY (UT) ANDAMAN & NICOBAR ISLANDS (UT)",25,0,25,25,0,25,0
"Mechanical Engineering (4 Years, Bachelor of Technology) PUNJAB",55,0,55,55,0,55,0
"Mechanical Engineering (4 Years, Bachelor of Technology) RAJASTHAN",59,0,59,59,0,59,0
"Mechanical Engineering (4 Years, Bachelor of Technology) SIKKIM",15,0,15,15,0,15,0
"Mechanical Engineering (4 Years, Bachelor of Technology) TAMIL NADU",59,0,59,59,0,59,0
"Mechanical Engineering (4 Years, Bachelor of Technology) TELANGANA",65,0,65,65,0,65,0
"Mechanical Engineering (4 Years, Bachelor of Technology) TRIPURA",48,14,62,46,14,60,-2
"Mechanical Engineering (4 Years, Bachelor of Technology) UTTAR PRADESH",77,5,82,77,5,82,0
"Mechanical Engineering (4 Years, Bachelor of Technology) UTTARAKHAND",15,3,18,18,0,18,0
"Mechanical Engineering (4 Years, Bachelor of Technology) WEST BENGAL",94,0,94,145,0,145,51
"Mechanical Engineering (5 Years, Bachelor and Master of Technology (Dual Degree))",45,7,52,50,3,53,1
"Mechanical Engineering (5 Years, Bachelor and Master of Technology (Dual Degree)) HARYANA",6,0,6,6,0,6,0
"Mechanical Engineering (5 Years, Bachelor and Master of Technology (Dual Degree)) Other than HARYANA",6,0,6,6,0,6,0
"Mechanical Engineering with Specialization in Manufacturing and Industrial Engineering (5 Years, Bachelor and Master of Technology (Dual Degree)) BIHAR",0,0,0,12,0,12,12
"Mechanical Engineering with Specialization in Manufacturing and Industrial Engineering (5 Years, Bachelor and Master of Technology (Dual Degree)) Other than BIHAR",0,0,0,11,0,11,11
"Mechanical Engineering with specialization in Design and Manufacturing (4 Years, Bachelor of Technology)",0,0,0,60,7,67,67
"Mechanical Engineering with specialization in Manufacturing and Industrial Engineering (5 Years, Bachelor and Master of Technology (Dual Degree)) BIHAR",12,0,12,0,0,0,-12
"Mechanical Engineering with specialization in Manufacturing and Industrial Engineering (5 Years, Bachelor and Master of Technology (Dual Degree)) Other than BIHAR",11,0,11,0,0,0,-11
"Mechatronics Engineering (4 Years, Bachelor of Technology)",20,0,20,59,0,59,39
"Mechatronics and Automation Engineering (4 Years, Bachelor of Technology)",0,0,0,60,6,66,66
"Mechatronics and Automation Engineering (4 Years, Bachelor of Technology) BIHAR",13,0,13,13,0,13,0
"Mechatronics and Automation Engineering (4 Years, Bachelor of Technology) Other than BIHAR",13,0,13,13,0,13,0
"Metallurgical Engineering (4 Years, Bachelor of Technology)",102,4,106,106,4,110,4
"Metallurgical Engineering (5 Years, Bachelor and Master of Technology (Dual Degree))",27,1,28,0,0,0,-28
"Metallurgical Engineering and Materials Science (4 Years, Bachelor of Technology)",162,14,176,152,6,158,-18
"Metallurgical and Materials Engineering (4 Years, Bachelor of Technology)",314,34,348,380,34,414,66
"Metallurgical and Materials Engineering (4 Years, Bachelor of Technology) ANDHRA PRADESH",0,0,0,15,0,15,15
"Metallurgical and Materials Engineering (4 Years, Bachelor of Technology) CHHATTISGARH",58,0,58,58,0,58,0
"Metallurgical and Materials Engineering (4 Years, Bachelor of Technology) JHARKHAND",49,0,49,49,0,49,0
"Metallurgical and Materials Engineering (4 Years, Bachelor of Technology) JK JAMMU & KASHMIR (UT)",50,1,51,37,1,38,-13
"Metallurgical and Materials Engineering (4 Years, Bachelor of Technology) KARNATAKA",29,1,30,29,0,29,-1
"Metallurgical and Materials Engineering (4 Years, Bachelor of Technology) LA LADAKH (UT)",2,0,2,2,0,2,0
"Metallurgical and Materials Engineering (4 Years, Bachelor of Technology) MAHARASHTRA",0,0,0,58,0,58,58
"Metallurgical and Materials Engineering (4 Years, Bachelor of Technology) ODISHA",30,0,30,30,0,30,0
"Metallurgical and Materials Engineering (4 Years, Bachelor of Technology) Other than ANDHRA PRADESH",0,0,0,15,0,15,15
"Metallurgical and Materials Engineering (4 Years, Bachelor of Technology) Other than CHHATTISGARH",57,0,57,57,0,57,0
"Metallurgical and Materials Engineering (4 Years, Bachelor of Technology) Other than JAMMU & KASHMIR (UT) LADAKH (UT)",50,3,53,37,3,40,-13
"Metallurgical and Materials Engineering (4 Years, Bachelor of Technology) Other than JHARKHAND",50,0,50,50,0,50,0
"Metallurgical and Materials Engineering (4 Years, Bachelor of Technology) Other than KARNATAKA",29,0,29,29,0,29,0
"Metallurgical and Materials Engineering (4 Years, Bachelor of Technology) Other than MAHARASHTRA",0,0,0,57,0,57,57
"Metallurgical and Materials Engineering (4 Years, Bachelor of Technology) Other than ODISHA",30,1,31,30,0,30,-1
"Metallurgical and Materials Engineering (4 Years, Bachelor of Technology) Other than RAJASTHAN",37,0,37,37,0,37,0
"Metallurgical and Materials Engineering (4 Years, Bachelor of Technology) Other than TAMIL NADU",39,0,39,39,0,39,0
"Metallurgical and Materials Engineering (4 Years, Bachelor of Technology) Other than TELANGANA",0,0,0,30,0,30,30
"Metallurgical and Materials Engineering (4 Years, Bachelor of Technology) Other than WEST BENGAL",38,0,38,38,0,38,0
"Metallurgical and Materials Engineering (4 Years, Bachelor of Technology) RAJASTHAN",37,0,37,37,0,37,0
"Metallurgical and Materials Engineering (4 Years, Bachelor of Technology) TAMIL NADU",40,0,40,40,0,40,0
"Metallurgical and Materials Engineering (4 Years, Bachelor of Technology) TELANGANA",0,0,0,30,0,30,30
"Metallurgical and Materials Engineering (4 Years, Bachelor of Technology) WEST BENGAL",37,0,37,37,0,37,0
"Metallurgical and Materials Engineering (5 Years, Bachelor and Master of Technology (Dual Degree)) ODISHA",6,0,6,6,0,6,0
"Metallurgical and Materials Engineering (5 Years, Bachelor and Master of Technology (Dual Degree)) Other than ODISHA",7,0,7,7,0,7,0
"Metallurgical and Materials Engineering (5 Years, Bachelor and Master of Technology (Dual Degree)) Other than TELANGANA",0,0,0,6,0,6,6
"Metallurgical and Materials Engineering (5 Years, Bachelor and Master of Technology (Dual Degree)) TELANGANA",0,0,0,6,0,6,6
"Metallurgy and Materials Engineering (4 Years, Bachelor of Technology)",0,0,0,82,1,83,83
"Metallurgy and Materials Engineering (4 Years, Bachelor of Technology) Other than WEST BENGAL",0,0,0,25,0,25,25
"Metallurgy and Materials Engineering (4 Years, Bachelor of Technology) WEST BENGAL",0,0,0,26,0,26,26
"Microelectronics & VLSI Engineering (4 Years, Bachelor of Technology) HARYANA",30,0,30,30,0,30,0
"Microelectronics & VLSI Engineering (4 Years, Bachelor of Technology) Other than HARYANA",30,0,30,30,0,30,0
"Mineral and Metallurgical Engineering (4 Years, Bachelor of Technology)",37,8,45,37,8,45,0
"Mining Engineering (4 Years, Bachelor of Technology)",321,40,361,297,26,323,-38
"Mining Engineering (4 Years, Bachelor of Technology) CHHATTISGARH",48,0,48,48,0,48,0
"Mining Engineering (4 Years, Bachelor of Technology) KARNATAKA",29,0,29,29,1,30,1
"Mining Engineering (4 Years, Bachelor of Technology) MAHARASHTRA",0,0,0,25,0,25,25
"Mining Engineering (4 Years, Bachelor of Technology) ODISHA",19,2,21,19,0,19,-2
"Mining Engineering (4 Years, Bachelor of Technology) Other than CHHATTISGARH",49,0,49,49,0,49,0
"Mining Engineering (4 Years, Bachelor of Technology) Other than KARNATAKA",29,1,30,29,0,29,-1
"Mining Engineering (4 Years, Bachelor of Technology) Other than MAHARASHTRA",0,0,0,25,0,25,25
"Mining Engineering (4 Years, Bachelor of Technology) Other than ODISHA",19,3,22,19,0,19,-3
"Mining Engineering (4 Years, Bachelor of Technology) Other than WEST BENGAL",0,0,0,26,0,26,26
"Mining Engineering (4 Years, Bachelor of Technology) WEST BENGAL",0,0,0,25,0,25,25
"Mining Engineering (5 Years, Bachelor and Master of Technology (Dual Degree))",28,2,30,0,0,0,-30
"Mining Engineering (5 Years, Bachelor and Master of Technology (Dual Degree)) ODISHA",6,0,6,6,0,6,0
"Mining Engineering (5 Years, Bachelor and Master of Technology (Dual Degree)) Other than ODISHA",6,0,6,6,0,6,0
"Mining Machinery Engineering (4 Years, Bachelor of Technology)",47,9,56,47,9,56,0
"Naval Architecture and Ocean Engineering (4 Years, Bachelor of Technology)",69,9,78,69,9,78,0
"Ocean Engineering and Naval Architecture (4 Years, Bachelor of Technology)",71,9,80,71,9,80,0
"Petroleum Engineering (4 Years, Bachelor of Technology)",79,11,90,79,11,90,0
"Pharmaceutical Engineering & Technology (4 Years, Bachelor of Technology)",80,0,80,75,0,75,-5
"Pharmaceutical Engineering & Technology (5 Years, Bachelor and Master of Technology (Dual Degree))",21,0,21,0,0,0,-21
"Physical Science (5 Years, Integrated Bachelor of Science-Master of Science)",0,0,0,26,0,26,26
"Physics (4 Years, Bachelor of Science)",85,9,94,97,10,107,13
"Physics (5 Years, Bachelor of Science and Master of Science (Dual Degree))",37,3,40,25,2,27,-13
"Physics (5 Years, Bachelor of Science and Master of Science (Dual Degree)) Other than TRIPURA",13,0,13,20,0,20,7
"Physics (5 Years, Bachelor of Science and Master of Science (Dual Degree)) TRIPURA",12,0,12,20,0,20,8
"Physics (5 Years, Integrated Master of Science)",0,0,0,45,3,48,48
"Physics (5 Years, Integrated Master of Science) GUJARAT",0,0,0,25,0,25,25
"Physics (5 Years, Integrated Master of Science) ODISHA",13,0,13,13,0,13,0
"Physics (5 Years, Integrated Master of Science) Other than GUJARAT",0,0,0,25,0,25,25
"Physics (5 Years, Integrated Master of Science) Other than ODISHA",12,0,12,12,0,12,0
"Physics (5 Years, Integrated Master of Science) Other than TELANGANA",0,0,0,10,0,10,10
"Physics (5 Years, Integrated Master of Science) TELANGANA",0,0,0,10,0,10,10
"Physics and Computational Engineering (4 Years, Bachelor of Technology)",0,0,0,30,0,30,30
"Physics with Specialization (4 Years, Bachelor of Science)",24,6,30,24,6,30,0
"Planning (4 Years, Bachelor of Planning)",0,0,0,119,0,119,119
"Planning (4 Years, Bachelor of Planning) MADHYA PRADESH",21,5,26,21,5,26,0
"Planning (4 Years, Bachelor of Planning) Other than MADHYA PRADESH",21,5,26,21,5,26,0
"Printing and Packaging Technology (4 Years, Bachelor of Technology)",0,0,0,30,0,30,30
"Production Engineering (4 Years, Bachelor of Technology) KERALA",30,0,30,29,0,29,-1
"Production Engineering (4 Years, Bachelor of Technology) Other than KERALA",29,0,29,30,0,30,1
"Production Engineering (4 Years, Bachelor of Technology) Other than TAMIL NADU",59,0,59,59,0,59,0
"Production Engineering (4 Years, Bachelor of Technology) Other than TRIPURA",45,12,57,33,12,45,-12
"Production Engineering (4 Years, Bachelor of Technology) TAMIL NADU",59,0,59,59,0,59,0
"Production Engineering (4 Years, Bachelor of Technology) TRIPURA",44,12,56,33,12,45,-11
"Production and Industrial Engineering (4 Years, Bachelor of Technology)",131,16,147,309,14,323,176
"Production and Industrial Engineering (4 Years, Bachelor of Technology) HARYANA",20,0,20,20,0,20,0
"Production and Industrial Engineering (4 Years, Bachelor of Technology) JHARKHAND",31,0,31,31,0,31,0
"Production and Industrial Engineering (4 Years, Bachelor of Technology) Other than HARYANA",20,0,20,20,0,20,0
"Production and Industrial Engineering (4 Years, Bachelor of Technology) Other than JHARKHAND",31,0,31,31,0,31,0
"Production and Industrial Engineering (4 Years, Bachelor of Technology) Other than UTTAR PRADESH",28,2,30,28,2,30,0
"Production and Industrial Engineering (4 Years, Bachelor of Technology) UTTAR PRADESH",29,1,30,29,1,30,0
Program Name,0,0,0,0,0,0,0
"Quantitative Economics & Data Science (5 Years, Integrated Master of Science)",0,0,0,35,3,38,38
"ROBOTICS & AUTOMATION (4 Years, Bachelor of Technology) HARYANA",25,0,25,25,0,25,0
"ROBOTICS & AUTOMATION (4 Years, Bachelor of Technology) Other than HARYANA",25,0,25,25,0,25,0
"Robotics and AI (4 Years, Bachelor of Technology)",0,0,0,30,0,30,30
"SUSTAINABLE ENERGY TECHNOLOGIES (4 Years, Bachelor of Technology) HARYANA",30,0,30,30,0,30,0
"SUSTAINABLE ENERGY TECHNOLOGIES (4 Years, Bachelor of Technology) Other than HARYANA",30,0,30,30,0,30,0
"Smart Manufacturing (4 Years, Bachelor of Technology)",0,0,0,117,12,129,129
"Space Science and Engineering (4 Years, Bachelor of Technology)",0,0,0,20,0,20,20
"Space Sciences and Engineering (4 Years, Bachelor of Technology)",20,0,20,0,0,0,-20
"Statistics and Data Science (4 Years, Bachelor of Science)",22,6,28,22,6,28,0
"Textile Technology (4 Years, Bachelor of Technology)",91,5,96,85,0,85,-11
"Textile Technology (4 Years, Bachelor of Technology) Other than PUNJAB",38,1,39,35,0,35,-4
"Textile Technology (4 Years, Bachelor of Technology) PUNJAB",37,2,39,35,0,35,-4
"VLSI Design and Technology (4 Years, Bachelor of Technology) DELHI (NCT) CHANDIGARH (UT)",13,0,13,13,0,13,0
"VLSI Design and Technology (4 Years, Bachelor of Technology) Other than DELHI (NCT) CHANDIGARH (UT)",12,0,12,12,0,12,0
